Ms^Xm, Ms^Xm, Ms^Xm, Ms^Xm, Ms^Xm, Ms^Xm, Ms^Xm, Ms^Xm, Ms^Xm, Ms^Xm, Ms^Xm, Ms^Xm, Ms^Xm, Ms^Xm, Ms^Xm, Ms^Xm, Ms^Xm
Ms^Xm, Ms^Xm, Ms^Xm, Ms^Xm, Ms^Xm, Ms^Xm, Ur, Ms^Xm, 2 Ur, Ms^Xm, Ur, Ms^Xm, Ms^Xm, Ms^Xm, Ms^Xm, Ms^Xm, Ms^Xm
Ms^Xm, Ms^Xm, Ms^Xm, Ms^Xm, Urb, Ur, Ur, Ur, Ur^Eb, Ur, Ur, Ur, Urb, Ms^Xm, Ms^Xm, Ms^Xm, Ms^Xm
Ms^Xm, Ms^Xm, Urb, Urb, Urb, Urb, Urb, Ur, Ur, Ur, Urb, Urb, Urb, Urb, Urb, Ms^Xm, Ms^Xm
Ms^Xm, Ms^Xm, Urb, Urb, Ms^Xm, Urb, Urb, Urb, Ur, Urb, Urb, Urb, Ms^Xm, Urb, Urb, Ms^Xm, Ms^Xm
Ms^Xm, Ms^Xm, Urb, Urb, Ms^Xm, Ms^Xm, Urb, Urb, Ur, Urb, Urb, Ms^Xm, Ms^Xm, Urb, Urb, Ms^Xm, Ms^Xm
Ms^Xm, Ms^Xm, Urb, Urb, Ms^Xm, Urb, Ms^Xm, Urb, Ur, Urb, Ms^Xm, Urb, Ms^Xm, Urb, Urb, Ms^Xm, Ms^Xm
Ms^Xm, Ms^Xm, Urb, Urb, Ms^Xm, Ms^Xm, Urb, Urb, 1 Ur, Urb, Urb, Ms^Xm, Ms^Xm, Urb, Urb, Ms^Xm, Ms^Xm
Ms^Xm, Ms^Xm, Ms^Xm, Ms^Xm, Urb, Urb, Urb, Urb, Ur, Urb, Urb, Urb, Urb, Ms^Xm, Ms^Xm, Ms^Xm, Ms^Xm
Ms^Xm, Ms^Xm, Ms^Xm, Ms^Xm, Ms^Xm, Urb, Urb, Urb, Ur, Urb, Urb, Urb, Ms^Xm, Ms^Xm, Ms^Xm, Ms^Xm, Ms^Xm
Ms^Xm, Ms^Xm, Ms^Xm, Ms^Xm, Ms^Xm, Ms^Xm, Ms^Xm, Urb, Ur, Urb, Ms^Xm, Ms^Xm, Ms^Xm, Ms^Xm, Ms^Xm, Ms^Xm, Ms^Xm
Ms^Xm, Ms^Xm, Ms^Xm, Ms^Xm, Ms^Xm, Ms^Xm, Ms^Xm, Ms^Xm, Ur, Ms^Xm, Ms^Xm, Ms^Xm, Ms^Xm, Ms^Xm, Ms^Xm, Ms^Xm, Ms^Xm
Ms^Xm, Ms^Xm, Ms^Xm, Ms^Xm, Ms^Xm, Ms^Xm, Ms^Xm, Ms^Xm, Urb, Ms^Xm, Ms^Xm, Ms^Xm, Ms^Xm, Ms^Xm, Ms^Xm, Ms^Xm, Ms^Xm
