Xoc^Efs, Xoc^Efs, Xoc^Efs, Xoc^Efs, Xoc^Efs, Xoc^Efs, Xoc^Efs, Xoc^Efs, Xoc^Efs, Xoc^Efs, Xoc^Efs, Xoc^Efs, Xoc^Efs, Xoc^Efs, Xoc^Efs, Xoc^Efs, Xoc^Efs
Xoc^Efs, Xoc^Efs, Xoc^Efs, Xoc^Efs, Xoc^Efs, Xoc^Efs, Ur^Edb, Xoc^Efs, 2 Ur, Xoc^Efs, Ur^Edb, Xoc^Efs, Xoc^Efs, Xoc^Efs, Xoc^Efs, Xoc^Efs, Xoc^Efs
Xoc^Efs, Xoc^Efs, Xoc^Efs, Xoc^Efs, Urb, Ur, Ur, Ur, Ur^Eb, Ur, Ur, Ur, Urb^Edb, Xoc^Efs, Xoc^Efs, Xoc^Efs, Xoc^Efs
Xoc^Efs, Xoc^Efs, Urb, Urb, Urb, Urb, Urb, Ur, Ur, Ur, Urb, Urb, Urb, Urb^Edt, Urb, Xoc^Efs, Xoc^Efs
Xoc^Efs, Xoc^Efs, Urb^Esd, Urb, Xoc^Efs, Urb^Edt, Urb, Urb^Edb, Ur, Urb, Urb, Urb, Xoc^Efs, Urb, Urb, Xoc^Efs, Xoc^Efs
Xoc^Efs, Xoc^Efs, Urb, Urb^Edt, Xoc^Efs, Xoc^Efs, Urb, Urb, Ur, Urb^Edt, Urb, Xoc^Efs, Xoc^Efs, Urb, Urb, Xoc^Efs, Xoc^Efs
Xoc^Efs, Xoc^Efs, Urb, Urb, Xoc^Efs, Urb, Xoc^Efs, Urb, Ur, Urb, Xoc^Efs, Urb, Xoc^Efs, Urb^Esd, Urb, Xoc^Efs, Xoc^Efs
Xoc^Efs, Xoc^Efs, Urb^Edt, Urb, Xoc^Efs, Xoc^Efs, Urb, Urb, 1 Ur, Urb^Edt, Urb, Xoc^Efs, Xoc^Efs, Urb, Urb, Xoc^Efs, Xoc^Efs
Xoc^Efs, Xoc^Efs, Xoc^Efs, Xoc^Efs, Urb, Urb, Urb, Urb, Ur, Urb, Urb, Urb^Esd, Urb, Xoc^Efs, Xoc^Efs, Xoc^Efs, Xoc^Efs
Xoc^Efs, Xoc^Efs, Xoc^Efs, Xoc^Efs, Xoc^Efs, Urb^Edt, Urb, Urb, Ur, Urb, Urb, Urb^Edb, Xoc^Efs, Xoc^Efs, Xoc^Efs, Xoc^Efs, Xoc^Efs
Xoc^Efs, Xoc^Efs, Xoc^Efs, Xoc^Efs, Xoc^Efs, Xoc^Efs, Xoc^Efs, Urb, Ur, Urb, Xoc^Efs, Xoc^Efs, Xoc^Efs, Xoc^Efs, Xoc^Efs, Xoc^Efs, Xoc^Efs
Xoc^Efs, Xoc^Efs, Xoc^Efs, Xoc^Efs, Xoc^Efs, Xoc^Efs, Xoc^Efs, Xoc^Efs, Ur, Xoc^Efs, Xoc^Efs, Xoc^Efs, Xoc^Efs, Xoc^Efs, Xoc^Efs, Xoc^Efs, Xoc^Efs
Xoc^Efs, Xoc^Efs, Xoc^Efs, Xoc^Efs, Xoc^Efs, Xoc^Efs, Xoc^Efs, Xoc^Efs, Urb, Xoc^Efs, Xoc^Efs, Xoc^Efs, Xoc^Efs, Xoc^Efs, Xoc^Efs, Xoc^Efs, Xoc^Efs
