Urb^Br\, Xos, Xos, Xos, Xos, Xos, Xos, Xos, Xos, Xos, Xos, Xos, Xos, Xos, Xos, Xos, Urb, Xos, Xos, Xos, Xos, Xos, Xos, Xos, Xos, Xos, Xos, Xos, Xos, Xos, Xos, Xos
Xos, Urb^Br\, Urb^Br\, Xos, Xos, Xos, Xos, Xos, Urb, Urb, Urb, Urb, Urb, Urb, Urb, Xos, 1 Urb, Xos, Urb, Urb, Urb, Urb, Urb, Urb, Urb, Urb, Urb, Urb, Urb, Urb, Xos, Xos
Xos, Xos, Urb, Urb^Br\, Urb^Br\, Xos, Urb^Br/, Urb^Br/, Urb^Br\, Urb, Urb, Urb, Urb, Urb, Urb, Xos, Urb, Xos, Urb, Urb, Urb, Urb, Urb, Urb, Urb, Urb, Urb, Urb, Urb, Urb, Xos, Xos
Xos, Xos, Urb, Urb, Urb, Urb^Br\, Urb^Br\, Uu^Vud, Uu^Vud, Urb^Br\, Urb^Br\, Urb, Urb, Urb, Urb, Urb, Urb, Urb, Urb, Urb, Urb, Urb, Urb, Urb, Urb, Urb, Urb, Urb, Urb, Urb, Xos, Xos
Xos, Xos, Urb, Urb, Urb, Uu^Vud, Uu^Vud, Urb^Br\, Urb^Br\, Uu^Vud, Urb^Br/, Urb^Br\, Urb, Urb, Urb, Urb, Urb, Urb, Urb, Urb, Urb, Urb, Urb, Urb, Urb, Urb, Urb, Urb, Urb, Urb, Xos, Xos
Xos, Xos, Urb, Urb, Urb, Urb, Urb, Uu^Vud, Urb, Urb^Br/, Urb, Urb^Br|, Urb, Urb, Urb, Urb, Urb, Urb, Urb, Urb, Urb, Urb, Urb, Urb, Urb, Urb, Urb, Urb, Urb, Urb, Xos, Xos
Xos, Xos, Urb, Urb, Urb, Urb, Urb, Urb, Urb, Urb, Urb, Urb^Br|, Urb, Urb, Urb, Urb, Urb, Urb, Urb, Urb, Urb, Urb, Urb, Urb, Urb, Urb, Urb, Urb, Urb, Urb, Xos, Xos
Ql, Xos, Urb, Urb, Urb, Urb, Urb, Urb, Urb, Urb, Urb, Urb^Br|, Urb, Urb, Urb, Urb, Urb, Urb, Urb, Urb, Urb, Urb, Urb, Urb, Urb, Urb, Urb, Urb, Urb, Urb, Xos, Xos
Ql, Ql, Ql, Urb, Urb, Urb, Urb, Urb, Urb, Urb, Urb^Br/, Urb^Br|, Urb, Urb, Urb, Urb, Urb, Urb, Urb, Urb, Urb, Urb, Urb, Urb, Urb, Urb, Urb, Urb, Urb, Urb, Xos, Xos
Ql, Ql, Ql, Ql, Qxu^Bcx/, Urb, Urb, Urb, Urb^Br/, Urb^Br/, Urb, Urb^Br|, Urb, Urb, Urb, Urb, Urb, Urb, Urb, Urb, Urb, Urb, Urb, Urb, Urb, Urb, Urb, Urb, Urb, Urb, Ql, Ql
Xos, Ql, Qxu^Bcx/, Qxu^Bcx/, Ql, Ql, Ql^Br/, Urb^Br/, Urb, Urb, Urb, Urb^Br|, Urb, Urb, Urb, Urb, Urb, Urb, Urb, Urb, Urb, Urb, Urb, Urb, Urb, Urb, Urb, Urb, Ql, Ql, Ql, Ql
Xos, Urb, Urb, Ql, Ql^Br/, Ql^Br/, Ql, Ql, Ql, Urb, Urb, Urb^Br|, Urb, Urb, Urb, Urb, Ql^Xo, Urb, Urb, Urb, Urb, Urb, Urb, Urb, Urb, Urb, Ql, Qxu^Bcx\, Qxu^Bcx\, Ql, Ql, Ql
Xos, Xos, Urb, Urb, Urb^Br|, Ql, Ql, Ql, Ql, Ql, Qxu^Bcx/, Urb^Br|, Urb, Urb, Ql^Xo, Ql^Xo, Ql^Xo, Ql^Xo, Ql^Xo, Urb, Urb, Urb, Urb, Urb, Ql, Ql, Ql, Ql, Ql, Qxu^Bcx\, Urb, Xos
Xos, Xos, Urb, Urb, Urb^Br|, Urb, Urb, Ql, Qxu^Bcx/, Qxu^Bcx/, Ql, Ql^Br|, Ql^Xo, Ql^Xo, Ql^Xo, Ql^Xo, Qxua^_s, Ql^Xo, Ql^Xo, Ql^Xo, Ql^Xo, Urb, Ql, Qxu^Bcx\, Qxu^Bcx\, Ql, Ql, Ql, Urb, Urb, Urb, Xos
Xos, Xos, Urb, Urb, Urb^Br|, Urb, Urb, Urb, Urb, Ql, Ql^Br/, Ql^Br/, Ql^Xo, Ql^Xo, Qxua^_s, Qxua^_s, Urb^_s, Qxua^_s, Qxua^_s, Ql^Xo, Ql^Xo, Ql^Xo, Ql, Ql, Ql, Qxu^Bcx\, Urb, Urb, Urb, Urb, Xos, Xos
Xos, Xos, Urb, Urb, Urb^Br|, Urb, Urb, Urb, Urb^Br/, Urb^Br/, Urb, Ql^Xo, Ql^Xo, Qxua^_s, Urb^_s, Urb^_s, Urb^_s, Urb^_s, Urb^_s, Qxua^_s, Ql^Xo, Ql^Xo, Ql, Ql, Urb, Urb, Urb, Urb, Urb, Urb, Xos, Xos
Xos, Xos, Urb, Urb, Urb^Br|, Urb, Urb^Br/, Urb^Br/, Urb, Urb, Urb, Ql^Xo, Ql^Xo, Qxua^_s, Urb^_s, Urb^_s, Kud^_s, Urb^_s, Urb^_s, Qxua^_s, Ql^Xo, Ql^Xo, Urb, Urb, Urb, Urb, Urb, Urb, Urb, Urb, Xos, Xos
Xos, Xos, Urb, Urb, Urb^Br/, Urb^Br/, Urb, Urb, Urb, Urb, Urb, Ql^Xo, Ql^Xo, Qxua^_s, Urb^_s, Urb^_s, Urb^_s, Urb^_s, Urb^_s, Qxua^_s, Ql^Xo, Ql^Xo, Urb, Urb, Urb, Urb, Urb, Urb, Urb, Urb, Xos, Xos
Xos, Xos, Urb^Br/, Urb^Br/, Urb^Br|, Urb, Urb, Urb, Urb, Urb, Urb, Ql^Xo, Ql^Xo, Qxua^_s, Urb^_s, Urb^_s, Urb^_s, Urb^_s, Urb^_s, Qxua^_s, Ql^Xo, Ql^Xo, Urb, Urb, Urb, Urb, Urb, Urb, Urb, Urb, Xos, Xos
Xos, Urb^Br|, Urb, Urb, Urb^Br|, Urb, Urb, Urb, Urb, Urb, Ql, Ql^Xo, Ql^Xo, Qxua^_s, Qxua^_s, Urb^_s, Urb^_s, Urb^_s, Qxua^_s, Qxua^_s, Ql^Xo, Ql^Xo, Ql, Urb, Urb, Urb, Urb, Urb, Urb, Urb, Xos, Xos
Xos, Urb^Br|, Urb, Urb, Urb^Br|, Urb, Urb, Urb, Qxu^Bcx\, Ql, Ql, Ql^Xo, Ql^Xo, Ql^Xo, Ql^Xo, Qxua^_s, Qxua^_s, Qxe^_s, Ql^Xo, Ql^Xo, Ql^Xo, Ql^Xo, Ql, Ql, Qxu^Bcx/, Urb, Urb, Urb, Urb, Urb, Xos, Xos
Xos, Urb^Br|, Urb, Urb, Urb^Br|, Urb, Ql, Ql, Ql, Qxu^Bcx\, Qxu^Bcx\, Ql, Urb, Ql^Xo, Ql^Xo, Ql^Xo, Ql^Xo, Ql^Xo, Ql^Xo, Ql^Xo, Urb, Ql, Qxu^Bcx/, Qxu^Bcx/, Ql, Ql, Ql, Urb, Urb, Urb, Urb, Xos
Urb^Br/, Urb^Br/, Urb, Urb, Ql, Ql^Br\, Ql^Br\, Ql, Ql, Ql, Urb, Urb, Urb, Urb, Urb, Ql^Xo, Ql^Xo, Ql^Xo, Urb, Urb, Urb, Urb, Urb, Ql, Ql, Ql, Ql, Ql, Ql, Urb, Urb, Xos
Xos, Urb, Qxu^Bcx\, Ql, Ql, Ql, Ql, Ql^Br\, Urb^Br\, Urb, Urb, Urb, Urb, Urb, Urb, Urb, Urb, Urb, Urb, Urb, Urb, Urb, Urb, Urb, Urb, Ql, Ql, Ql, Qxu^Bcx/, Qxu^Bcx/, Ql, Xos
Ql, Ql, Ql, Qxu^Bcx\, Qxu^Bcx\, Ql, Urb, Urb, Urb, Urb^Br|, Urb, Urb, Urb, Urb, Urb, Urb, Urb, Urb, Urb, Urb, Urb, Urb, Urb, Urb, Urb, Urb, Urb, Qxu^Bcx/, Ql, Ql, Ql, Ql
Ql, Ql, Ql, Ql, Urb, Urb, Urb, Urb, Urb, Urb^Br|, Urb, Urb, Urb, Urb, Urb, Urb, Urb, Urb, Uu^Vu, Urb, Urb, Urb, Urb, Urb, Urb, Urb, Urb, Urb, Urb, Ql, Ql, Ql
Ql, Ql, Urb, Urb, Urb, Urb, Urb, Urb, Urb, Urb^Br|, Urb, Urb, Urb, Urb, Urb, Urb, Urb, Urb, Urb, Urb, Urb, Urb, Urb, Urb, Urb, Urb, Urb, Urb, Urb, Urb, Urb, Ql
Xos, Urb, Urb, Urb, Urb, Urb, Urb, Urb, Urb, Urb^Br|, Urb, Urb, Urb, Urb, Urb, Urb, Urb, Urb, Urb, Urb, Urb, Urb, Urb, Urb, Urb, Urb, Urb, Urb, Urb, Urb, Xos, Xos
Xos, Urb, Urb, Urb, Urb, Urb, Urb, Urb, Urb, Urb^Br|, Urb, Urb, Urb, Urb, Urb, Urb, Urb, Urb, Urb, Urb, Urb, Urb, Urb, Urb, Urb, Urb, Urb, Urb, Urb, Urb, Xos, Xos
Xos, Urb, Urb, Urb, Urb, Urb, Urb, Urb, Urb, Urb^Br|, Urb, Urb, Urb, Urb, Urb, Urb, Urb, Urb, Urb, Urb, Urb, Urb, Urb, Urb, Urb, Urb, Urb, Urb, Urb, Urb, Urb, Xos
Xos, Urb, Xos, Urb, Xos, Urb, Xos, Xos, Xos, Urb^Br|, Xos, Urb, Xos, Urb, Xos, Urb, Xos, Urb, Xos, Urb, Xos, Urb, Xos, Urb, Xos, Urb, Xos, Urb, Xos, Urb, Xos, Xos
Xos, Xos, Xos, Xos, Xos, Xos, Xos, Xos, Urb, Urb^Br/, Xos, Xos, Xos, Xos, Xos, Xos, Xos, Xos, Xos, Xos, Xos, Xos, Xos, Xos, Xos, Xos, Xos, Xos, Xos, Xos, Xos, Xos
