Ql^Qov, Ql^Qov, Ql^Qov, Ql^Qov, Ql^Qov, Ql^Qov, Ql^Qov, Ql^Qov, Ql^Qov, Ql^Qov, Ql^Qov, Ql^Qov, Ql^Qov, Ql^Qov, Ql^Qov, Ql^Qov, Co^Qov, Ql^Qov, Ql^Qov, Ql^Qov, Ql^Qov, Ql^Qov, Ql^Qov, Ql^Qov, Ql^Qov, Ql^Qov, Ql^Qov, Ql^Qov, Ql^Qov, Ql^Qov, Ql^Qov, Ql^Qov
Ql^Qov, Ql^Qov, Ql^Qov, Ql^Qov, Ql^Qov, Ql^Qov, Ql^Qov, Ql^Qov, Ql^Qov, Ql^Qov, Ql^Qov, Ql^Qov, Ql^Qov, Ql^Qov, Co^Qov, Co^Qov, Ur, Co^Qov, Co^Qov, Ql^Qov, Ql^Qov, Ql^Qov, Ql^Qov, Ql^Qov, Ql^Qov, Ql^Qov, Ql^Qov, Ql^Qov, Ql^Qov, Ql^Qov, Ql^Qov, Ql^Qov
Ql^Qov, Ql^Qov, Ql^Qov, Ql^Qov, Ql^Qov, Ql^Qov, Ql^Qov, Ql^Qov, Ql^Qov, Ql^Qov, Ql^Qov, Ql^Qov, Co^Qov, Co^Qov, Ur, Ur, Ur^Ii, Ur, Ur^Es, Co^Qov, Co^Qov, Ql^Qov, Ql^Qov, Ql^Qov, Ql^Qov, Ql^Qov, Ql^Qov, Ql^Qov, Ql^Qov, Ql^Qov, Ql^Qov, Ql^Qov
Ql^Qov, Ql^Qov, Ql^Qov, Ql^Qov, Ql^Qov, Ql^Qov, Ql^Qov, Ql^Qov, Ql^Qov, Ql^Qov, Co^Qov, Co^Qov, Ur, Ur, Ur^Es, Ur^Ii, Hh^Vhh, Ur^Ii, Ur, Ur, Ur, Co^Qov, Co^Qov, Ql^Qov, Ql^Qov, Ql^Qov, Ql^Qov, Ql^Qov, Ql^Qov, Ql^Qov, Ql^Qov, Ql^Qov
Ql^Qov, Ql^Qov, Ql^Qov, Ql^Qov, Ql^Qov, Ql^Qov, Ql^Qov, Ql^Qov, Co^Qov, Co^Qov, Ur, Ur, Ur, Ur, Ur, Ur^Ii, Ur^Ii, Ur^Ii, Ur, Ur^Edb, Ur, Ur, Ur, Co^Qov, Co^Qov, Ql^Qov, Ql^Qov, Ql^Qov, Ql^Qov, Ql^Qov, Ql^Qov, Ql^Qov
Ql^Qov, Ql^Qov, Ql^Qov, Ql^Qov, Ql^Qov, Ql^Qov, Co^Qov, Co^Qov, Ur, Ur, Ur, Ur, Xoc, Ur, Ur^Edb, Ur, Ur, Ur, Ur, Ur, Xoc, Ur, Ur, Ur, Ur^Es, Co^Qov, Co^Qov, Ql^Qov, Ql^Qov, Ql^Qov, Ql^Qov, Ql^Qov
Ql^Qov, Ql^Qov, Ql^Qov, Ql^Qov, Co^Qov, Co^Qov, Ur, Ur, Ur, Ur, Ur, Xoc, Ur, Ur, Ur, Ur, Ur^Es, Ur, Ur^Es, Ur, Ur, Xoc, Ur, Ur^Es, Ur, Ur, Ur, Co^Qov, Co^Qov, Ql^Qov, Ql^Qov, Ql^Qov
Ql^Qov, Ql^Qov, Co^Qov, Co^Qov, Ur^Es, Ur^Es, Ur, Ur, Xoc, Xoc, Ur, Ur, Ur, Xoc, Ur, Ur, Ur, Ur^Em, Ur, Xoc, Ur, Ur, Ur, Xoc, Xoc, Ur, Ur, Ur^Edt, Ur^Es, Co^Qov, Co^Qov, Ql^Qov
Ql^Qov, Co^Qov, Ur^Es, Ur, Ur, Ur, Xoc, Ur, Ur, Ur, Ur, Ur, Ur, Xoc, Ur, Ur, Ur, Ur, Ur, Xoc, Ur, Ur, Ur, Ur, Ur, Ur, Xoc, Ur, Ur, Ur, Co^Qov, Ql^Qov
Ql^Qov, Co^Qov, Ur, Ur^Es, Ur, Xoc, Ur, Ur, Ur, Ur^Edt, Ur^Es, Ur, Ur, Xoc, Ur, Ur, Ur, Ur, Ur^Es, Xoc, Ur, Ur^Edt, Ur^Esd, Ur^Es, Ur, Ur, Ur^Es, Xoc, Ur, Ur, Co^Qov, Ql^Qov
Ql^Qov, Co^Qov, Ur, Ur^Es, Xoc, Ur^Es, Ur, Ur^Esd, Ur, Ur^Es, Ur, Ur, Ur, Xoc, Ur, Ur, Ur^Es, Ur, Ur, Xoc, Ur, Ur, Ur, Ur^Es, Ur, Ur, Ur, Ur, Ur, Ur, Co^Qov, Ql^Qov
Ql^Qov, Co^Qov, Ur^Edt, Ur^Edt, Ur, Ur, Ur, Ur^Es, Ur, Ur, Xoc, Xoc, Ur, Ur, Qxua, Qxua, Qxua, Qxua, Qxua, Ur, Ur, Xoc, Xoc, Ur, Ur, Ur^Edt, Ur, Ur, Ur, Ur, Co^Qov, Ql^Qov
Ql^Qov, Co^Qov, Ur, Ur, Uu^Vu, Ur, Ur, Ur, Xoc, Xoc, Ur, Ur, Qxua, Qxua, Qxua, Qxua, Qxua, Qxua, Qxua, Qxua, Ur, Ur, Ur, Xoc, Xoc, Ur, Ur, Uu^Vu, Ur, Ur, Co^Qov, Ql^Qov
Ql^Qov, Co^Qov, Ur, Ur^Es, Ur, Ur, Ur, Ur^Em, Ur, Ur, Ur, Ur, Qxua, Qxua, Khr, Khr, 2 Khr, Khr, Qxua, Qxua, Ur, Ur^Edb, Ur, Ur, Ur, Ur, Ur, Ur, Ur, Ur, Co^Qov, Ql^Qov
Ql^Qov, Co^Qov, Ur, Ur, Xoc, Ur, Ur^Edt, Ur^Es, Xoc, Ur, Ur, Ur, Qxua, Qxua, Khr, Khr, Khr, Khr, Qxua, Qxua, Ur, Ur, Ur, Ur, Xoc, Ur, Ur, Xoc, Ur, Ur, Co^Qov, Ql^Qov
Ql^Qov, Co^Qov, Ur, Ur, Ur, Ur, Ur, Ur, Xoc, Ur, Ur, Ur, Qxua, Qxua, Khr, Khr, Khr, Khr, Qxua, Qxua, Ur, Ur, Ur, Ur^Es, Xoc, Ur, Ur, Ur, Ur^Es, Ur, Co^Qov, Ql^Qov
Ql^Qov, Co^Qov, Ur, Ur, Xoc, Ur, Ur, Ur, Xoc, Ur, Ur, Ur, Qxua, Qxua, Khr, Khr, Khr, Khr, Qxua, Qxua, Ur, Ur^Es, Ur^Edb, Ur, Xoc, Ur^Edt, Ur, Xoc, Ur, Ur, Co^Qov, Ql^Qov
Ql^Qov, Co^Qov, Ur, Ur, Xoc, Ur, Ur^Es, Ur, Xoc, Ur, Ur^Edt, Ur, Qxua, Qxua, Qxua, Khr^Qov, Qxua, Khr, Qxua, Qxua, Ur, Ur, Ur, Ur, Xoc, Ur, Ur, Xoc, Ur, Ur, Co^Qov, Ql^Qov
Ql^Qov, Co^Qov, Ur, Ur, Ur, Ur, Ur, Ur, Xoc, Ur, Ur^Es, Ur, Ur, Qxua, Qxua, Qxu^Qov, Qxua, Qxua, Qxua, Qxua, Ur, Ur, Ur, Ur, Xoc, Ur, Ur^Edt, Ur, Ur, Ur^Edt, Co^Qov, Ql^Qov
Ql^Qov, Co^Qov, Ur, Ur^Es, Xoc, Ur^Es, Ur, Ur, Ur^Edb, Ur, Ur, Ur, Ur, Ur, Ur^Ecf, Qxu^Bcx|, Ur^Ecf, Qxua, Ur, Ur, Ur^Es, Ur^Edt, Ur, Ur, Ur, Ur^Es, Ur, Xoc, Ur, Ur^Edb, Co^Qov, Ql^Qov
Ql^Qov, Co^Qov, Ur, Ur, Xoc, Ur, Ur^Es, Ur, Ur, Xoc, Xoc, Ur, Ur, Ur^Es, Ur, 1 Ur, Ur, Ur, Ur^Edb, Ur, Ur, Ur, Xoc, Xoc, Ur, Ur, Ur, Xoc, Ur, Ur, Co^Qov, Ql^Qov
Ql^Qov, Co^Qov, Ur, Ur, Ur, Ur, Ur, Ur, Ur, Ur, Ur, Xoc, Xoc, Ur^Em, Ur, Ur, Ur, Ur, Ur, Ur, Xoc, Xoc, Ur^Es, Ur, Ur, Ur, Ur, Ur, Ur^Edb, Ur, Co^Qov, Ql^Qov
Ql^Qov, Co^Qov, Ur, Ur^Es, Ur^Edb, Ur, Xoc, Ur, Ur^Edt, Ur, Ur^Es, Ur, Ur, Xoc, Ur^Esd, Ur^Edb, Ur, Ur, Ur^Es, Xoc, Ur, Ur, Ur, Ur^Em, Ur, Ur, Xoc, Ur^Edt, Ur, Ur, Co^Qov, Ql^Qov
Ql^Qov, Co^Qov, Co^Qov, Ur, Ur, Ur, Ur, Xoc, Uu^Vu, Ur, Ur, Ur, Ur^Es, Ur, Ur, Ur, Ur^Es, Ur, Ur, Ur, Ur, Ur, Ur, Ur, Uu^Vu, Xoc, Ur, Ur^Es, Ur, Ur, Co^Qov, Ql^Qov
Ql^Qov, Ql^Qov, Ql^Qov, Co^Qov, Co^Qov, Ur, Ur, Ur^Edb, Ur, Xoc, Xoc, Ur, Ur, Ur, Xoc, Ur, Ur, Ur, Xoc, Ur^Es, Ur, Ur, Xoc, Xoc, Ur^Esd, Ur, Ur, Ur, Co^Qov, Co^Qov, Ql^Qov, Ql^Qov
Ql^Qov, Ql^Qov, Ql^Qov, Ql^Qov, Ql^Qov, Co^Qov, Co^Qov, Ur, Ur, Ur, Ur, Ur, Xoc, Xoc, Xoc, Ur, Ur, Ur, Xoc, Xoc, Xoc, Ur, Ur, Ur, Ur, Ur^Edb, Co^Qov, Co^Qov, Ql^Qov, Ql^Qov, Ql^Qov, Ql^Qov
Ql^Qov, Ql^Qov, Ql^Qov, Ql^Qov, Ql^Qov, Ql^Qov, Ql^Qov, Co^Qov, Co^Qov, Ur^Es, Ur, Ur, Ur^Es, Xoc, Xoc, Ur, Ur^Es, Ur, Xoc, Xoc, Ur, Ur, Ur, Ur^Es, Co^Qov, Co^Qov, Ql^Qov, Ql^Qov, Ql^Qov, Ql^Qov, Ql^Qov, Ql^Qov
Ql^Qov, Ql^Qov, Ql^Qov, Ql^Qov, Ql^Qov, Ql^Qov, Ql^Qov, Ql^Qov, Ql^Qov, Co^Qov, Co^Qov, Ur, Ur, Ur, Ur, Ur^Edb, Ur, Ur, Ur, Ur^Es, Ur, Ur, Co^Qov, Co^Qov, Ql^Qov, Ql^Qov, Ql^Qov, Ql^Qov, Ql^Qov, Ql^Qov, Ql^Qov, Ql^Qov
Ql^Qov, Ql^Qov, Ql^Qov, Ql^Qov, Ql^Qov, Ql^Qov, Ql^Qov, Ql^Qov, Ql^Qov, Ql^Qov, Ql^Qov, Co^Qov, Co^Qov, Ur, Gd^Fetd, Ur, Rrc, Ur, Gd^Fetd, Ur, Co^Qov, Co^Qov, Ql^Qov, Ql^Qov, Ql^Qov, Ql^Qov, Ql^Qov, Ql^Qov, Ql^Qov, Ql^Qov, Ql^Qov, Ql^Qov
Ql^Qov, Ql^Qov, Ql^Qov, Ql^Qov, Ql^Qov, Ql^Qov, Ql^Qov, Ql^Qov, Ql^Qov, Ql^Qov, Ql^Qov, Ql^Qov, Ql^Qov, Co^Qov, Co^Qov, Rrc, Rrc^Es, Rrc, Co^Qov, Co^Qov, Ql^Qov, Ql^Qov, Ql^Qov, Ql^Qov, Ql^Qov, Ql^Qov, Ql^Qov, Ql^Qov, Ql^Qov, Ql^Qov, Ql^Qov, Ql^Qov
Ql^Qov, Ql^Qov, Ql^Qov, Ql^Qov, Ql^Qov, Ql^Qov, Ql^Qov, Ql^Qov, Ql^Qov, Ql^Qov, Ql^Qov, Ql^Qov, Ql^Qov, Ql^Qov, Ql^Qov, Rrc, Rrc^Edb, Rrc, Ql^Qov, Ql^Qov, Ql^Qov, Ql^Qov, Ql^Qov, Ql^Qov, Ql^Qov, Ql^Qov, Ql^Qov, Ql^Qov, Ql^Qov, Ql^Qov, Ql^Qov, Ql^Qov
Ql^Qov, Ql^Qov, Ql^Qov, Ql^Qov, Ql^Qov, Ql^Qov, Ql^Qov, Ql^Qov, Ql^Qov, Ql^Qov, Ql^Qov, Ql^Qov, Ql^Qov, Ql^Qov, Ql^Qov, Rrc, Rrc, Rrc, Ql^Qov, Ql^Qov, Ql^Qov, Ql^Qov, Ql^Qov, Ql^Qov, Ql^Qov, Ql^Qov, Ql^Qov, Ql^Qov, Ql^Qov, Ql^Qov, Ql^Qov, Ql^Qov
