Ql^Xo, Ql^Xo, Ql^Xo, Ql^Xo, Ql^Xo, Ql^Xo, Ql^Xo, Ql^Xo, Ql^Xo, Ql^Xo, Ql^Xo, Ql^Xo, Ql^Xo, Ql^Xo, Ql^Xo, Ql^Xo, Ko^Xo, Ql^Xo, Ql^Xo, Ql^Xo, Ql^Xo, Ql^Xo, Ql^Xo, Ql^Xo, Ql^Xo, Ur^Br|, Ql^Xo, Ql^Xo, Ql^Xo, Ql^Xo, Ql^Xo, Ql^Xo
Ql^Xo, Ql^Xo, Ql^Xo, Ql^Xo, Ql^Xo, Ql^Xo, Ql^Xo, Ql^Xo, Ql^Xo, Ql^Xo, Ql^Xo, Ql^Xo, Ql^Xo, Ql^Xo, Co^Xo, Co^Xo, Ur, Co^Xo, Co^Xo, Ql^Xo, Ql^Xo, Ql^Xo, Ql^Xo, Ql^Xo, Ql^Xo, Ur^Br|, Ql^Xo, Ql^Xo, Ql^Xo, Ql^Xo, Ql^Xo, Ql^Xo
Ql^Xo, Ql^Xo, Ql^Xo, Ql^Xo, Ql^Xo, Ql^Xo, Ql^Xo, Ql^Xo, Ql^Xo, Ql^Xo, Ql^Xo, Ql^Xo, Co^Xo, Co^Xo, Ur, Ur, Ur^Ii, Ur, Ur^Es, Co^Xo, Co^Xo, Ql^Xo, Ql^Xo, Ql^Xo, Ql^Xo, Ur^Br|, Ql^Xo, Ql^Xo, Ql^Xo, Ql^Xo, Ql^Xo, Ql^Xo
Ql^Xo, Ql^Xo, Ql^Xo, Ql^Xo, Ql^Xo, Ql^Xo, Ql^Xo, Ql^Xo, Ql^Xo, Ql^Xo, Co^Xo, Co^Xo, Ur, Ur, Ur^Es, Ur^Ii, Hh^Vhh, Ur^Ii, Ur, Ur, Ur, Co^Xo, Co^Xo, Ql^Xo, Ql^Xo, Ur^Br|, Ql^Xo, Ql^Xo, Ql^Xo, Ql^Xo, Ql^Xo, Ql^Xo
Ql^Xo, Ql^Xo, Ql^Xo, Ql^Xo, Ql^Xo, Ql^Xo, Ql^Xo, Ql^Xo, Co^Xo, Co^Xo, Ur, Ur, Ur, Ur, Ur, Ur^Ii, Ur^Ii, Ur^Ii, Ur, Ur^Edb, Ur, Ur, Ur, Co^Xo, Ko^Xo, Ur^Br|, Ql^Xo, Ql^Xo, Ql^Xo, Ql^Xo, Ql^Xo, Ql^Xo
Ql^Xo, Ql^Xo, Ql^Xo, Ql^Xo, Ql^Xo, Ql^Xo, Co^Xo, Co^Xo, Ur, Ur, Ur, Ur, Xoc, Ur, Ur^Edb, Ur, Ur, Ur, Ur, Ur, Xoc, Ur, Ur, Ur, Ur^Es, Ur^Qov, Ko^Xo, Ql^Xo, Ql^Xo, Ql^Xo, Ql^Xo, Ql^Xo
Ql^Xo, Ql^Xo, Ql^Xo, Ql^Xo, Co^Xo, Co^Xo, Ur, Ur, Ur, Ur, Ur, Xoc, Ur, Ur, Ur, Ur, Ur^Es, Ur, Ur^Es, Ur, Ur, Xoc, Ur, Ur^Es, Ur, Ur^Br|, Ur, Co^Xo, Co^Xo, Ql^Xo, Ql^Xo, Ql^Xo
Ql^Xo, Ql^Xo, Co^Xo, Co^Xo, Ur^Es, Ur^Es, Ur, Ur, Xoc, Xoc, Ur, Ur, Ur, Xoc, Ur, Ur, Ur, Ur^Em, Ur, Xoc, Ur, Ur, Ur, Xoc, Xoc, Ur^Br|, Ur, Ur^Edt, Ur^Es, Co^Xo, Co^Xo, Ql^Xo
Ql^Xo, Ko^Xo, Ur^Es, Ur, Ur, Ur, Xoc, Ur, Ur, Ur, Ur, Ur, Ur, Xoc, Ur, Ur, Ur, Ur, Ur, Xoc, Ur, Ur, Ur, Ur, Ur, Ur^Br|, Xoc, Ur, Ur, Ur, Co^Xo, Ql^Xo
Ql^Xo, Co^Xo, Ur, Ur^Es, Ur, Xoc, Ur, Ur, Ur, Ur^Edt, Ur^Es, Ur, Ur, Xoc, Ur, Ur, Ur, Ur, Ur^Es, Xoc, Ur, Ur^Edt, Ur^Esd, Ur^Es, Ur, Ur^Br\, Ur^Br|, Xoc, Ur, Ur, Co^Xo, Ql^Xo
Ql^Xo, Co^Xo, Ur, Ur^Es, Xoc, Ur^Es, Ur, Ur^Esd, Ur, Ur^Es, Ur, Ur, Ur, Xoc, Ur, Ur, Ur^Es, Ur, Ur, Xoc, Ur, Ur, Ur, Ur^Es, Ur, Ur, Ur^Br|, Ur, Ur, Ur, Co^Xo, Ql^Xo
Ql^Xo, Co^Xo, Ur^Edt, Ur^Edt, Ur, Ur, Ur, Ur^Es, Ur, Ur, Xoc, Xoc, Ur, Ur, Qxua, Qxua, Qxua, Qxua, Qxua, Ur, Ur, Xoc, Xoc, Ur, Ur, Ur^Edt, Ur^Br|, Ur, Ur, Ur, Co^Xo, Ql^Xo
Ql^Xo, Co^Xo, Ur, Ur, Uu^Vu, Ur, Ur, Ur, Xoc, Xoc, Ur, Ur, Qxua, Qxua, Qxua, Qxua, Qxua, Qxua, Qxua, Qxua, Ur, Ur, Ur, Xoc, Xoc, Ur, Ur^Br|, Uu^Vud, Ur, Ur, Co^Xo, Ql^Xo
Ql^Xo, Co^Xo, Ur, Ur^Es, Ur, Ur, Ur, Ur^Em, Ur, Ur, Ur, Ur, Qxua, Qxua, Khr, Khr, 2 Khr, Khr, Qxua, Qxua, Ur, Ur^Edb, Ur, Ur, Ur, Ur, Ur^Br|, Ur, Ur, Ur, Co^Xo, Ql^Xo
Ql^Xo, Co^Xo, Ur, Ur, Xoc, Ur, Ur^Edt, Ur^Es, Xoc, Ur, Ur, Ur, Qxua, Qxua, Khr, Khr, Khr, Khr, Qxua, Qxua, Ur, Ur, Ur, Ur, Xoc, Ur, Ur^Br|, Xoc, Ur, Ur, Co^Xo, Ql^Xo
Ql^Xo, Co^Xo, Ur, Ur, Ur, Ur, Ur, Ur, Xoc, Ur, Ur, Ur, Qxua, Qxua, Khr, Khr, Khr, Khr, Qxua, Qxua, Ur, Ur, Ur, Ur^Es, Xoc, Ur, Ur^Br|, Ur, Ur^Es, Ur, Co^Xo, Ql^Xo
Ql^Xo, Co^Xo, Ur, Ur, Xoc, Ur, Ur, Ur, Xoc, Ur, Ur, Ur, Qxua, Qxua, Khr, Khr, Khr, Khr, Qxua, Qxua, Ur, Ur^Es, Ur^Edb, Ur, Xoc, Ur^Edt, Ur^Br|, Xoc, Ur, Ur, Co^Xo, Ql^Xo
Ql^Xo, Co^Xo, Ur, Ur, Xoc, Ur, Ur^Es, Ur, Xoc, Ur, Ur^Edt, Ur, Qxua, Qxua, Qxua, Khr^Qov, Qxua, Khr, Qxua, Qxua, Ur, Ur, Ur, Ur, Xoc, Ur, Ur^Br|, Xoc, Ur, Ur, Co^Xo, Ql^Xo
Ql^Xo, Co^Xo, Ur, Ur, Ur, Ur, Ur, Ur, Xoc, Ur, Ur^Es, Ur, Ur, Qxua, Qxua, Qxu^Qov, Qxua, Qxua, Qxua, Qxua, Ur, Ur, Ur, Ur, Xoc, Ur, Ur^Br|, Ur, Ur, Ur^Edt, Co^Xo, Ql^Xo
Ql^Xo, Co^Xo, Ur, Ur^Es, Xoc, Ur^Es, Ur, Ur, Ur^Edb, Ur, Ur, Ur, Ur, Ur, Ur^Ecf, Qxu^Bcx|, Ur^Ecf, Qxua, Ur, Ur, Ur^Es, Ur^Edt, Ur, Ur, Ur, Ur^Es, Ur^Br|, Xoc, Ur, Ur^Edb, Co^Xo, Ql^Xo
Ql^Xo, Co^Xo, Ur, Ur, Xoc, Ur, Ur^Es, Ur, Ur, Xoc, Xoc, Ur, Ur, Ur^Es, Ur, 1 Ur, Ur, Ur, Ur^Edb, Ur, Ur, Ur, Xoc, Xoc, Ur, Ur, Ur^Br|, Xoc, Ur, Ur, Co^Xo, Ql^Xo
Ql^Xo, Co^Xo, Ur, Ur, Ur, Ur, Ur, Ur, Ur, Ur, Ur, Xoc, Xoc, Ur^Em, Ur, Ur, Ur, Ur, Ur, Ur, Xoc, Xoc, Ur^Es, Ur, Ur, Ur, Ur^Br\, Ur, Ur^Edb, Ur, Co^Xo, Ql^Xo
Ql^Xo, Co^Xo, Ur, Ur^Es, Ur^Edb, Ur, Xoc, Ur, Ur^Edt, Ur, Ur^Es, Ur, Ur, Xoc, Ur^Esd, Ur^Edb, Ur, Ur, Ur^Es, Xoc, Ur, Ur, Ur, Ur^Em, Ur, Ur, Xoc, Ur^Br\, Ur^Br\, Ur, Ko^Xo, Ql^Xo
Ql^Xo, Ko^Xo, Co^Xo, Ur, Ur, Ur, Ur, Xoc, Uu^Vu, Ur, Ur, Ur, Ur^Es, Ur, Ur, Ur, Ur^Es, Ur, Ur, Ur, Ur, Ur, Ur, Ur, Uu^Vu, Xoc, Ur, Ur^Es, Ur, Ur^Xo, Ur^Br|, Ql^Xo
Ql^Xo, Ql^Xo, Ql^Xo, Co^Xo, Co^Xo, Ur, Ur, Ur^Edb, Ur, Xoc, Xoc, Ur, Ur, Ur, Xoc, Ur, Ur, Ur, Xoc, Ur^Es, Ur, Ur, Xoc, Xoc, Ur^Esd, Ur, Ur, Ur, Co^Xo, Ko^Xo, Ur^Br|, Ql^Xo
Ql^Xo, Ql^Xo, Ql^Xo, Ql^Xo, Ql^Xo, Co^Xo, Co^Xo, Ur, Ur, Ur, Ur, Ur, Xoc, Xoc, Xoc, Ur, Ur, Ur, Xoc, Xoc, Xoc, Ur, Ur, Ur, Ur, Ur^Edb, Co^Xo, Co^Xo, Ql^Xo, Ql^Xo, Ur^Br|, Ql^Xo
Ql^Xo, Ql^Xo, Ql^Xo, Ql^Xo, Ql^Xo, Ql^Xo, Ql^Xo, Co^Xo, Co^Xo, Ur^Es, Ur, Ur, Ur^Es, Xoc, Xoc, Ur, Ur^Es, Ur, Xoc, Xoc, Ur, Ur, Ur, Ur^Es, Co^Xo, Co^Xo, Ql^Xo, Ql^Xo, Ql^Xo, Ql^Xo, Ur^Br|, Ql^Xo
Ql^Xo, Ql^Xo, Ql^Xo, Ql^Xo, Ql^Xo, Ql^Xo, Ql^Xo, Ql^Xo, Ql^Xo, Co^Xo, Co^Xo, Ur, Ur, Ur, Ur, Ur^Edb, Ur, Ur, Ur, Ur^Es, Ur, Ur, Co^Xo, Co^Xo, Ql^Xo, Ql^Xo, Ql^Xo, Ql^Xo, Ql^Xo, Ql^Xo, Ur^Br|, Ql^Xo
Ql^Xo, Ql^Xo, Ql^Xo, Ql^Xo, Ql^Xo, Ql^Xo, Ql^Xo, Ql^Xo, Ql^Xo, Ql^Xo, Ql^Xo, Co^Xo, Co^Xo, Ur, Gd^Fetd, Ur, Rrc, Ur, Gd^Fetd, Ur, Co^Xo, Co^Xo, Ql^Xo, Ql^Xo, Ql^Xo, Ql^Xo, Ql^Xo, Ql^Xo, Ql^Xo, Ql^Xo, Ur^Br|, Ql^Xo
Ql^Xo, Ql^Xo, Ql^Xo, Ql^Xo, Ql^Xo, Ql^Xo, Ql^Xo, Ql^Xo, Ql^Xo, Ql^Xo, Ql^Xo, Ql^Xo, Ql^Xo, Co^Xo, Ko^Xo, Rrc, Rrc^Es, Rrc, Ko^Xo, Co^Xo, Ql^Xo, Ql^Xo, Ql^Xo, Ql^Xo, Ql^Xo, Ql^Xo, Ql^Xo, Ql^Xo, Ql^Xo, Ql^Xo, Ur^Br|, Ql^Xo
Ql^Xo, Ql^Xo, Ql^Xo, Ql^Xo, Ql^Xo, Ql^Xo, Ql^Xo, Ql^Xo, Ql^Xo, Ql^Xo, Ql^Xo, Ql^Xo, Ql^Xo, Ql^Xo, Ql^Xo, Rrc, Rrc^Edb, Rrc, Ql^Xo, Ql^Xo, Ql^Xo, Ql^Xo, Ql^Xo, Ql^Xo, Ql^Xo, Ql^Xo, Ql^Xo, Ql^Xo, Ql^Xo, Ur^Br/, Ql^Xo, Ql^Xo
Ql^Xo, Ql^Xo, Ql^Xo, Ql^Xo, Ql^Xo, Ql^Xo, Ql^Xo, Ql^Xo, Ql^Xo, Ql^Xo, Ql^Xo, Ql^Xo, Ql^Xo, Ql^Xo, Ql^Xo, Rrc, Rrc, Rrc, Ql^Xo, Ql^Xo, Ql^Xo, Ql^Xo, Ql^Xo, Ql^Xo, Ql^Xo, Ql^Xo, Ql^Xo, Ql^Xo, Ql^Xo, Ur^Br|, Ql^Xo, Ql^Xo
