Xoc, Ql, Xoc, Uue, Xoc, Uue, Ql, Ql, Ql, Ql, Ql, Qxu^Bs|, Ql, Ql, Ql, Ql, Xoc, Xoc, Xoc, Xoc, Ql, Ql, Ql, Ql, Xoc, Ql, Ql, Ql, Ql, Ql, Ql, Ql, Ql, Uue, Uue, Uue, Uue, Uu^Vu, Uue, Uue, Uue, Uue
Xoc, Ql, Xoc, Uue, Uue, Uue, Uue, Ql, Ql, Ql, Ql, Qxu^Bs|, Ql, Ql, Ql, Ql, Uue, Uue, Uue, Xoc, Ql, Ql, Ql, Ql, Ur, Ql, Uue, Ql, Ql, Ql, Ql, Ql, Uue, Uue, Uue, Uu^Vu, Uue, Uue, Uue, Uue, Uue, Uue
Uue, Ql, Uue, Uue, Uue, Uue, Uue, Uue, Uue, Ql, Ql, 1 Qxu^Bs|, Ql, Ql, Ql, Ql, Uue, Uue, Uue^Esd, Uue, Uue, Ql, Ql, Uu^Vu, Ur, Uue, Uue, Uue, Uue, Uue, Uue, Uue, Uue, Uue, Uue, Uue, Uue, Uue, Uue, Uue, Uue, Urb
Uue, Ql, Xoc, Uue, Uue, Uue, Uue, Uue, Uue, Uue, Uue, Ur, Uue, Uue, Uue, Uue, Uue, Uue, Uue, Xu, Uue, Uue, Uue, Uue, Uue, Ur, Ur, Uue, Uue, Uue, Uue, Uue, Uue, Uue, Uue, Uue, Uue^Esd, Uue, Uue, Uu^Vu, Uue, Uue
Uue, Uue, Urb, Xoc, Uue, Uue, Uue, Uue, Uue, Uu^Vu, Uue, Ur, Uue, Uue, Uue, Uue, Uue, Uue, Xu, Xu, Qxua, Uue, Uue, Uue, Xu, Xu, Ur, Uue, Uue, Uue, Uue, Uue, Uue, Uue, Uue, Uue, Uue, Uue, Uu^Vu, Uue, Uue, Uue
Urb, Uue, Uue, Uue, Uue, Uue, Uue, Uue, Uue, Xu, Xu, Ur, Ur, Uue, Urb, Uue, Uue, Uue, Xu, Qxua, Qxua, Qxua, Qxua, Xu, Xu, Uu^Vu, Ur, Uue, Uue, Uue^Edb, Uue, Uue^Esd, Uue, Uue, Uue, Uue, Uue, Uue, Uue, Uue, Uue, Uue
Urb, Urb, Urb, Urb, Uue, Uue, Uue, Uue, Uue, Xu, Xu, Xu, Ur, Urb, Uu^Vu, Uue, Uue, Uue, Uu^Vu, Xu, Qxua, Xu, Xu, Uue, Uue, Uue^Esd, Ur, Uue, Uue, Uue, Uue, Uue, Uue, Uue, Qxua, Qxua, Qxua, Qxua, Uue, Uue, Uue, Urb
Urb, Xoc, Xoc, Uue, Uue, Uue, Uue, Uue^Esd, Uue, Uue, Xu, Xu, Ur, Xu, Xu, Qxua, Uue, Uue, Uue, Uue, Uue^Esd, Uue, Uue, Uue, Uue, Qxua, Ur, Uue, Uue, Uue, Uue, Uue, Uue, Qxua, Qxua, Qxua, Xue, Uue, Uue, Uue, Qxua, Urb
Urb, Uu^Vu, Uue, Uue, Uue, Uue, Uue, Uue, Ur, Ur, Ur, Ur, Ur, Xu, Xu, Qxua, Qxua, Uue^Edb, Uue, Uue, Uue, Uue, Qxua, Qxua, Qxua, Uue, Ur, Uue, Uue, Uue, Uue, Uu^Vu, Qxua, Qxua, Qxua, Qxua, Qxua, Uue, Uue, Qxua, Qxua, Qxua
Ql, Urb, Uue, Uue, Uue, Uue, Ur, Ur, Uue, Uue, Uue, Uu^Vu, Ur, Xu, Xu, Xu, Qxua, Qxua, Qxua, Qxua, Qxua, Qxua, Qxua, Qxua, Qxua, Ur, Uue, Uue, Uue, Qxua, Qxua, Qxua, Qxua, Qxua, Qxua, Uue, Uue, Qxua, Uue, Xue, Xue, Xue
Ql, Urb, Uue, Uue, Uue, Ur, Uue, Uue, Uue, Uue, Uue, Uue, Uue, Ur, Xu, Xu, Xu, Qxua, Qxua, Qxua, Qxua, Uue, Uue, Uue, Ur, Ur, Uue, Uue, Uu^Uf, Qxua, Uu^Uf, Qxua, Uue, Uue, Uue, Uue, Uue, Uue, Uu^Vu, Uue, Uue, Xue
Ql, Urb, Uue, Uue, Uue, Uue^Esd, Uue, Uue, Uue^Esd, Xu, Uue, Uue, Uue, Ur, Xu, Xu, Xu, Qxua, Qxua, Qxua, Uue, Uue, Uue, Uue, Ur, Uue, Uue, Uue, Uue, Uue, Qxua, Qxua, Uue, Uue, Uue, Uue, Uue, Xoc, Uue, Uue, Uue, Uue
Xoc, Urb, Uue, Uue, Uue^Edb, Uue, Uue, Uue, Uue, Xu, Urb, Urb, Urb, Ur, Ur, Xu, Xu, Qxua, Qxua, Qxua, Xu, Uue, Uue, Ur, Uue, Uue, Uue, Uue^Esd, Uue, Uue, Uue, Xoc, Uue, Uue, Uue, Uue, Xoc, Xoc, Uue, Uue, Uue, Uue
Ql, Urb, Uh, Uh, Uue, Uue, Uue^Esd, Uue, Uue, Xu, Urb, Urb, Urb, Urb, Ur, Xu, Xu, Xu, Xu, Xu, Xu, Uue^Esd, Uue, Ur, Uue, Uu^Vu, Uue, Uue, Uue, Uue, Uue, Uue, Uue, Uue, Xoc, Xoc, Xoc, Uue, Uue, Uue, Uue, Qxe
Ql, Urb, Uh, Uh, Uue, Uue, Uue, Uue, Xu, Xu, Urb, Urb, Urb, Urb, Ur, Xu, Xu, Xu, Xu, Xu, Xu, Uue, Ur, Ur, Uue, Uue, Uue, Uue, Xoc, Xoc, Uu^Uf, Uue, Uue, Uue, Uue, Uue, Xoc, Uue, Uu^Vu, Uue, Uue, Qxe
Urb, Urb, Qxua, Qxua, Uu^Vu, Uue, Uu^Vu, Uue, Xu, Xu, Xu, Uue, Uue, Uue, Ur, Uu^Vu, Xu, Xu, Xu, Xu, Uu^Ufi, Uu^Ufi, Ur, Uue, Uue, Uue, Uue, Uue, Uue, Uue, Uue, Uu^Vu, Ql, Ql, Uue, Uue, Uue, Xoc, Ql, Uue, Uue, Qxe
Urb, Qxua, Qxua, Qxua, Qxua, Urb, Urb, Uue, Uue, Uue, Xu, Xu, Xu, Xu, Ur, Uue, Uu^Ufi, Ql, Ql, Ql, Uu^Ufi, Uu^Vu, Ur, Uue, Uue, Uue, Xoc, Uue, Uue, Uue, Uue, Uue, Uue, Ql, Ql, Uue, Xoc, Xoc, Xoc, Uue, Uue, Uue
Urb, Qxua, Xu, Qxua, Qxua, Qxua, Uue, Urb, Uue, Uue^Edt, Uue, Uue, Uue, Ur, Uue, Uu^Ufi, Ql, Ql, Uue, Uue, Uu^Ufi, Uu^Ufi, Ur, Uue, Uue, Uue, Xoc, Xoc, Ql, Ql, Ql, Uue^Edb, Uue, Uue, Uue, Uue, Xoc, Xoc, Ql, Uue, Uue, Uue
Urb, Qxua, Xu, Xu, Qxua, Qxua, Uue, Urb, Uue, Uue^Edb, Uue, Uue, Uue, Ur, Urb, Uue, Ql, Uue, Uue, Uu^Ufi, Uu^Ufi, Uu^Ufi, Ur, Uu^Uf, Uu^Uf, Uu^Edb, Uu^Uf, Uue, Uu^Vu, Ql, Ql, Uue, Uue, Uue, Uue, Uue, Uue, Xoc, Ql, Uue, Uue, Uue
Urb, Qxua, Qxua, Xu, Xu, Qxua, Uue, Urb, Uue, Uue, Uue, Uue, Uue, Ur, Uu^Vu, Uue, Uue, Uu^Ufi, Uu^Ufi, Uue, Ur, Ur, Uu^Uf, Uu^Uf, Uue, Uue, Uue, Uue, Uue, Ql, Ql, Uue, Uue, Uue, Xoc, Uue, Uue, Uue, Uue, Uue, Uue, Uue
Ql, Urb, Qxua, Qxua, Xu, Qxua, Qxua, Uue, Uue, Uue, Uue, Uue^Edt, Uue, Ur, Uu^Ufi, Uu^Ufi, Uu^Ufi, Uu^Ufi, Uu^Ufi, Uu^Ufi, Ur, Urb, Uu^Uf, Uu^Uf, Uue, Uue, Uue, Uue, Uue, Ql, Ql, Uue, Uue, Uue, Uue, Xoc, Uue, Uue^Esd, Uue, Uue, Uue, Uue
Urb, Urb, Qxua, Qxua, Qxua, Qxua, Qxua, Uue, Uue, Uue, Uue, Uue, Uue, Ur, Uu^Ufi, Uue, Uue, Uue, Uue, Ur, Uu^Vu, Uu^Ufi, Uu^Uf, Uu^Uf, Uue, Uue, Uue, Uue, Uue, Uue, Uue, Ql, Ql, Uue, Uu^Vu, Uue, Xoc, Uue, Uue, Uue, Uue, Uue
Uue, Uu^Vu, Uue, Uue, Qxua, Qxua, Qxua, Uue, Uue, Uue, Uue, Urb, Urb, Ur, Uue, Uue, Uue, Uue, Uu^Ufi, Ur, Uu^Ufi, Uu^Ufi, Uu^Uf, Uu^Uf, Uue, Urb, Xoc, Xoc, Urb, Uue, Uue^Edt, Uue, Uue, Uue, Uue, Uue, Uue, Uu^Vu, Uue, Uue, Ql, Uue
Uue, Uue, Uue, Qxua, Qxua, Qxua, Qxu^Bs/, Uue, Qxua, Qxua, Uue, Urb, Urb, Ur, Uue, Uue, Uue, Uue, Uu^Ufi, Ur, Uu^Ufi, Uu^Uf, Uu^Uf, Uue, Uue, Xoc, Xoc, Xoc, Uue, Uue, Uue, Uue, Uue, Uue, Ql, Xoc, Uue, Uue, Uue, Ql, Ql, Uue
Uue, Uue, Uue^Esd, Uue, Uue, Uue, Qxua, Qxua, Qxua, Qxua, Qxua, Uue, Uue, Ur, Uue, Uue, Uue, Uue, Ur, Ur, Uu^Uf, Uu^Uf, Uu^Uf, Uu^Uf, Uue, Urb, Uue, Uue, Xoc, Xoc, Uue, Uue, Uue, Uue, Uue, Xoc, Uue, Uue, Ql, Ql, Ql, Uue
Urb, Uue, Uue, Uue, Uue, Qxua, Qxua, Qxua, Qxua, Uu^Vu, Qxua, Qxua, Qxua, Ur, Uu^Vu, Uue, Uue, Uue, Ur, Uue, Uu^Edb, Uu^Uf, Uu^Uf, Uu^Uf, Xu, Uue, Uue, Uue, Uue, Uue, Ql, Ql, Uue, Uue, Uue, Uue, Uue, Uue, Uue, Uue, Uue, Uue
Urb, Uue, Uue, Qxua, Qxua, Qxua, Qxua, Qxua, Qxua, Qxua, Uue, Uue, Qxua, Ur, Ur, Uue, Uue, Uue, Ur, Uue, Uue, Xu, Xu, Xu, Urb, Uue, Uue, Uue, Uue, Uue, Uue, Ql, Uue, Uue, Uue, Uue, Uue, Uue, Uue, Uue, Ql, Xoc
Uue, Uue, Uue, Qxua, Qxua, Urb, Urb, Qxua, Qxua, Qxua, Uue, Qxua, Qxua, Qxua, Qxua, Ur, Xu, Uue, Ur, Uue, Uue, Uue, Uue, Uue, Uue, Uue, Uue, Uue, Uue, Uue, Uue, Uue, Uue, Uue, Uue, Uue, Uue, Uue, Uue, Uue, Xoc, Xoc
Uue, Uue, Uue, Uue, Qxua, Qxua, Qxua, Qxua, Qxua, Qxua, Uue, Uue, Qxua, Ql, Qxua, Xu, Xu, Xu, Ur, Uu^Vu, Ur, Ur, Ur, Uue, Uue, Uue, Uue^Edt, Uue, Uue, Uue, Uue, Uue, Uue, Uue, Uue, Uue, Uue, Uue, Uue, Uue, Uue, Uue
Xu, Xu, Uue, Uue, Qxua, Qxua, Qxua, Qxua, Qxua, Uue, Uue, Uue, Qxua, Ql, Ql, Qxua, Qxua, Xu, Uue, Ur, Uue, Uue, Uue, Ur, Ur, Uue, Uue, Uue, Uue, Uue, Uue, Uue, Uue, Uue, Uue, Uue, Uue, Uue, Uue, Uue, Uue, Uue
Xu, Xu, Uue, Uue, Uue, Uue, Qxua, Uu^Vu, Qxua, Uue, Uue, Uue, Uue, Qxua, Ql, Qxua, Qxua, Ur, Uue, Uue, Uue, Xu, Uue, Uue, Uue, Ur, Ur, Uu^Vu, Ur, Uue, Ur, Ur, Ur, Uue, Uue, Uue, Uue, Uue, Uue, Uue, Uue, Uue
Xu, Uue, Xu, Xu, Uue, Uue, Uue, Qxua, Qxua, Uue, Uue, Uue, Uu^Vu, Uue, Urb, Qxua, Ur, Ur, Uue, Uue, Xu, Xu, Uue, Uue, Uue, Uue, Uue, Ur, Uue, Ur, Uue, Uu^Vu, Uue, Ur, Uue, Uue, Cud, Uue, Uue, Uue, Xoc, Xoc
Xu, Xu, Xu, Uue, Uu^Vu, Uue, Uue, Uue, Qxua, Uue, Ur^Edb, Ur, Ur, Ur, Ur, Qxu^Bs/, Uue, Uue, Xu, Xu, Xu, Uue, Uue, Uue, Uue, Uue, Uue, Uue, Uue, Uue, Uue, Uue, Uue, Ur, Cud, Cud, Cud, Cud, Cud, Uue, Xoc, Xoc
Xu, Xu, Xu, Ur, Ur, Ur, Ur, Uue, Ur, Ur, Urb, Xu, Uue, Uue, Uue, Uue, Uue, Uue, Uue, Xu, Xu, Uue, Uue, Uue, Uue, Uue, Uue, Uue^Edt, Uue, Uue, Uue, Uue, Uue, Ur, Cud, Cud, Cud, Cud, Cud, Uue, Uue, Uue
Xu, Xu, Xu, Uue, Urb, Uue^Edb, Uue, Ur, Uue, Xu, Xu, Xu, Xu, Uue, Uue, Uue, Uue, Uue, Uue, Uue, Xu, Xu, Uue, Uue, Uue, Uue, Uu^Vu, Uue, Uue, Uue, Xu, Qxu, Uue, Uue, Cud, Cud, Uu^Vud, Cud, Cud, Uue, Uue, Uue
Xu, Uue, Uue, Uue, Uue, Uue, Uue, Uue, Xu, Uue, Xu, Xu, Xu, Uue, Uue, Uue, Uue, Uue, Uue, Uue, Uue, Uue, Uue, Uue, Uue, Uue, Uue, Xu, Uue, Xu, Xu, Xu, Uue, Uue, Cud, Cud, Cud, Cud, Cud, Qxua, Qxua, Uue
Uue, Uue, Xu, Xu, Urb, Uue, Uue, Uue, Uu^Vu, Xu, Uue, Xu, Xu, Uue, Uue, Uue, Uue, Uue, Uue, Xu, Xu, Uue, Uue, Uue, Uue, Uue, Qxu, Xu, Xu, Xu, Xu, Uue, Uue, Uue, Uue, Cud, Cud, Cud, Qxua, Uu^Vu, Qxua, Qxua
Uue, Xu, Xu, Urb, Xu, Uue, Uue, Xu, Xu, Xu, Xu, Uue, Uue, Xu, Xu, Xu, Xu, Xu, Xu, Xu, Uue, Uue, Uue, Uue, Uue, Uue, Uue, Xu, Uue, Xu, Uue, Uue, Uu^Vu, Uue, Uue, Uue, Uue, Uue, Uue, Qxua, Qxua, Qxua
Uue, Xu, Uu^Vu, Xu, Uue, Uue, Uue, Uue, Xu, Xu, Qxua, Uue, Uue, Uue^Edb, Xu, Uue, Xu, Xu, Xu, Xu, Xu, Uue, Xoc, Xoc, Uue, Uue, Uue, Uue, Uue, Uue, Uue, Uue, Uue, Uue, Uue, Uue^Edt, Uue, Uue, Uue, Qxua, Qxua, Qxua
Xu, Xu, Xu, Uue, Uue, Uue, Qxu, Uue, Uue, Xu, Qxua, Uue, Uue, Uue, Xu, Xu, Xu, Xu, Uue, Xu, Xu, Uue, Uue, Uue, Uue, Uue, Uu^Vu, Uue^Edb, Uue, Uue, Uue, Uue^Edt, Uue, Uue, Uue, Uue, Xu, Uue, Uue, Qxua, Qxua, Qxua
Xu, Uue, Uue, Uue, Uue, Qxu, Uue, Uue, Xu, Xu, Xu, Qxua, Xu, Xu, Xu, Xu, Xu, Xu, Xu, Xu, Uue, Uue, Uue, Uue, Uue, Uue, Uue, Uue, Uue, Xu, Uue, Uue, Uue, Uue, Uue, Xu, Xu, Xu, Uue, Qxua^Edt, Qxua, Qxua
Xu, Uue, Uue, Xu, Uue, Qxu, Uue, Uue, Xu, Xu, Xu, Xu, Xu, Xu, Xu, Xu, Xu, Xu, Xu, Uue, Uue, Uue, Uue, Uue, Ql, Ql, Ql, Uue, Uue, Xu, Xu, Xu, Xu, Xu, Xu, Xu, Xu, Xu, Uue, Uue, Urb, Urb
