Xoc, Qlf, Qlf, Qlf, Qlf, Qlf, Qlf, Qlf, Ql, Ql, Ql, Qxu^Bs|, Ql, Ql, Ql^Br|, Ql, Xoc, Xoc, Xoc, Xoc, Qlf, Qlf, Qlf, Qlf, Xoc, Ql, Ql, Ql, Ql, Ql, Ql, Ql, Ql, Uue, Uue, Uue, Uue, Uu^Vu, Uue, Uue, Uue, Uue
Xoc, Ql, Qlf, Qlf, Qlf, Qlf, Uue, Ql, Ql, Ql, Ql, Qxu^Bs|, Ql, Ql, Ql^Br|, Ql, Uue, Uue, Uue, Xoc, Ql, Ql, Ql, Ql, Ur, Ql, Uue, Ql, Ql, Ql, Ql, Ql, Uue, Uue, Uue^Br/, Uu^Vu, Uue, Uue, Uue, Uue, Uue, Uue
Xue, Ql, Qlf, Qlf, Uue, Uue, Uue, Uue, Uue, Ql, Ql, 1 Qxu^Bs|, Ql, Ql, Ql^Br|, Ql, Uue, Uue, Uue^Esd, Uue, Uue, Ql, Ql, Uu^Vu, Ur, Uue, Uue, Uue, Uue, Uue, Uue, Uue, Uue^Br/, Uue^Br/, Uue, Uue, Uue, Uue, Uue, Uue, Uue, Urb
Xue, Ql, Xoc, Uue, Uue, Uue, Uue, Uue, Uue, Uue, Uue, Ur, Uue, Uue, Uue^Br|, Uue, Uue, Uue, Uue, Xu, Uue, Uue, Uue, Uue, Uue, Ur, Ur, Uue, Uue, Uue, Uue^Br/, Uue^Br/, Uue, Uue, Uue, Uue, Uue^Esd, Uue, Uue, Uu^Vu, Uue, Uue
Xue, Uue, Urb, Xoc, Uue, Uue, Uue, Uue, Uue, Uu^Vu, Uue, Ur, Uue, Uue, Uue^Br|, Uue, Uue, Uue, Xu, Xu, Qxua, Uue, Uue, Uue, Xu, Xu, Ur, Uue, Uue^Br/, Uue^Br/, Uue, Uue, Uue, Uue, Uue, Uue, Uue, Uue, Uu^Vu, Uue, Uue, Uue
Xue, Uue, Uue, Uue, Uue, Uue, Uue, Uue, Uue, Xu, Xu, Ur, Ur, Uue, Urb, Uue^Br\, Uue^Br|, Uue, Xu, Qxua, Qxua, Qxua, Qxua, Xu, Xu, Uu^Vu, Ur^Br/, Uue^Br/, Uue, Uu, Uue, Uue^Esd, Uue, Uue, Uue, Uue, Uue, Uue, Uue, Uue, Uue, Uue
Xue, Urb, Urb, Urb, Uue, Uue, Uue, Uue, Uue, Xu, Xu, Xu, Ur, Urb, Uu^Vu, Uue, Uue^Br\, Uue, Uu^Vu, Xu, Qxua, Xu, Xu, Uue, Uue^Br/, Uue^Br/, Ur, Uu, Uue, Uue, Uue, Uue, Uue, Uue, Qxua, Qxua, Qxua, Qxua, Uue, Uue, Uue, Urb
Xue, Xoc, Xoc, Uue, Uue, Uue, Uue, Uue^Esd, Uue, Uue, Xu, Xu, Ur, Xu, Xu, Qxua^Qov, Uue, Uue^Br\, Uue^Br\, Uue, Uue^Br\, Uue, Uue^Br/, Uue^Br/, Uue, Qxua, Ur, Uu, Uue, Uue, Uue, Uue, Uue, Qxua, Qxua, Qxua, Xue, Uue, Uue, Uue, Qxua, Urb
Xue, Uu^Vu, Uue, Uue, Uue, Uue, Uue, Uue, Ur, Ur, Ur, Ur, Ur, Xu, Xu, Qxua^Qov, Qxua^Qov, Uue^Edb, Uue, Uue^Br/, Uue, Uue^Br\, Qxua, Qxua, Qxua, Uue, Ur, Uu, Uue, Uue, Uue, Uu^Vu, Qxua, Qxu^Bs\, Qxu^Bs\, Qxua, Qxua, Uue, Qxu^Bs|, Qxua, Qxua, Qxua
Ql, Urb, Uue, Uue, Uue, Uue, Ur, Ur, Uue, Uue, Uue, Uu^Vu, Ur, Xu, Xu, Qxua, Qxua, Qxua^Qov, Qxua^Qov, Qxua^Qov, Qxua^Qov, Qxua^Br|, Qxua, Qxua, Qxua, Ur, Uue, Uu, Uue, Qxua, Qxua, Qxua, Qxua, Qxua, Qxua, Uue, Uue, Qxua, Uue, Xue, Xue, Xue
Ql, Urb, Uue, Uue, Uue, Ur, Uue, Uue, Uue, Uue, Uue, Uue, Uue, Ur, Xu, Qxua, Qxua, Qxua, Qxua, Qxua, Qxua^Qov, Uue^Br|, Uue, Uue, Ur, Ur, Uue, Uu, Uu^Uf, Qxua, Uu^Uf, Qxua, Uue, Uue, Uue, Uue, Uue, Uue, Uu^Vu, Uue, Uue, Xue
Ql, Urb, Uue, Uue, Uue, Uue^Esd, Uue, Uue, Uue^Esd, Xu, Uue, Uue, Uue, Ur, Xu, Qxua, Qxua, Qxua, Qxua, Qxua^Qov, Uue, Uue^Br|, Uue, Uue, Ur, Uue, Uue, Uu, Uue, Uue, Qxua, Qxua, Uue, Uue, Uue, Uue, Uue, Xoc, Uue, Uue, Uue, Uue
Xoc, Urb, Uue, Uue, Uue^Edb, Uue, Uue, Uue, Uue, Xu, Urb, Urb, Urb, Ur, Ur, Xu, Qxua, Qxua, Qxua, Qxua^Qov, Xu, Uue^Br|, Uue, Ur, Uue, Uue, Uue, Uue^Esd, Uue, Uue, Uue, Xoc, Uue, Uue, Uue, Uue, Xoc, Xoc, Uue, Uue, Uue, Uue
Ql, Urb, Uh, Uh, Uue, Uue, Uue^Esd, Uue, Uue, Xu, Urb, Urb, Urb, Urb, Ur, Xu, Qxua, Qxua, Xu, Xu, Xu, Uue^Br|, Uue^Br\, Ur, Uue, Uu^Vu, Uue, Uue, Uue, Uue, Uue, Uue, Uue, Uue, Xoc, Xoc, Xoc, Uue, Uue, Uue, Uue, Qxe
Ql, Urb, Uh, Uh, Uue, Uue, Uue, Uue, Xu, Xu, Urb, Urb, Urb, Urb, Ur, Xu, Xu, Xu, Xu, Xu, Xu, Uue, Ur, Ur^Br\, Uue^Br\, Uue, Uue, Uue, Xoc, Xoc, Uu^Uf, Uue, Uue, Uue, Uue, Uue, Xoc, Uue, Uu^Vu, Uue, Uue, Qxe
Urb, Urb, Qxua, Qxua, Uu^Vu, Uue, Uu^Vu, Uue, Xu, Xu, Xu, Uue, Uue, Uue, Ur, Uu^Vu, Xu, Xu, Xu, Xu, Uu^Ufi, Uu^Ufi, Ur, Uue, Uue, Uue^Br\, Uue, Uue, Uue, Uue, Uue, Uu^Vu, Ql, Ql, Uue, Uue, Uue, Xoc, Ql, Uue, Uue, Qxe
Urb, Qxua, Qxua, Qxua, Qxua, Urb, Urb, Uue, Uue, Uue, Xu, Xu, Xu, Xu, Ur, Uue, Uu^Ufi, Ql, Ql, Ql, Uu^Ufi, Uu^Vu, Ur, Uue, Uue, Uue^Br|, Xoc, Uue, Uue, Uue, Uue, Uue, Uue, Ql, Ql, Uue, Xoc, Xoc, Xoc, Uue, Uue, Uue
Urb, Qxua, Xu, Qxua, Qxua, Qxua, Uue, Urb, Uue, Uue^Edt, Uue, Uue, Uue, Ur, Uue, Uu^Ufi, Ql, Ql, Uue, Uue, Uu^Ufi, Uu^Ufi, Ur, Uue, Uue, Uue^Br|, Xoc, Xoc, Ql, Ql, Ql, Uue^Edb, Uue, Uue, Uue, Uue, Xoc, Xoc, Ql, Uue, Uue, Uue
Urb, Qxua, Xu, Xu, Qxu^Bcx/, Qxu^Bcx/, Uue, Urb, Uue, Uue^Edb, Uue, Uue, Uue, Ur, Urb, Uue, Ql, Uue, Uue, Uu^Ufi, Uu^Ufi, Uu^Ufi, Ur, Uu^Uf, Uu^Uf, Uu^Br|, Uu^Uf, Uue, Uu^Vu, Ql, Ql, Uue, Uue, Uue, Uue, Uue, Uue, Xoc, Ql, Uue, Uue, Uue
Xue, Qxua, Qxu^Bcx/, Qxu^Bcx/, Xu, Qxua, Uue, Urb, Uue, Uue, Uue, Uue, Uue, Ur, Uu^Vu, Uue, Uue, Uu^Ufi, Uu^Ufi, Uue, Ur, Ur, Uu^Uf, Uu^Uf, Uue, Uue^Br|, Uue, Uue, Uue, Ql, Ql, Uue, Uue, Uue, Xoc, Uue, Uue, Uue, Uue, Uue, Uue, Uue
Ql, Urb, Qxua, Qxua, Xu, Qxua, Qxua, Uue, Uue, Uue, Uue, Uue^Edt, Uue, Ur, Uu^Ufi, Uu^Ufi, Uu^Ufi, Uu^Ufi, Uu^Ufi, Uu^Ufi, Ur, Urb, Uu^Uf, Uu^Uf, Uue, Uue^Br|, Uue^Br\, Uue, Uue, Ql, Ql, Uue, Uue, Uue, Uue, Xoc, Uue, Uue^Esd, Uue, Uue, Uue, Uue
Xue, Urb, Qxua, Qxua, Qxua, Qxua, Qxua, Uue, Uue, Uue, Uue, Uue, Uue, Ur, Uu^Ufi, Uue, Uue, Uue, Uue, Ur, Uu^Vu, Uu^Ufi, Uu^Uf, Uu^Uf, Uue, Uue, Uue, Uue^Br\, Uue^Br\, Uue, Uue, Ql, Ql, Uue, Uu^Vu, Uue, Xoc, Uue, Uue, Uue, Uue, Uue
Xue, Uu^Vu, Uue, Uue, Qxua, Qxua, Qxua, Uue, Uue, Uue, Uue, Urb, Urb, Ur, Uue, Uue, Uue, Uue, Uu^Ufi, Ur, Uu^Ufi, Uu^Ufi, Uu^Uf, Uu^Uf, Uue, Urb, Xoc, Xoc, Urb, Uue^Br\, Uue^Br\, Uue, Uue, Uue, Uue, Uue, Uue, Uu^Vu, Uue, Uue, Ql, Uue
Xue, Uue, Uue, Qxua, Qxua, Qxua, Qxu^Bs/, Uue, Qxua, Qxua, Uue, Urb, Urb, Ur, Uue, Uue, Uue, Uue, Uu^Ufi, Ur, Uu^Ufi, Uu^Uf, Uu^Uf, Uue, Uue, Xoc, Xoc, Xoc, Uue, Uue, Uue, Uue^Br\, Uue^Br\, Uue, Ql, Xoc, Uue, Uue, Uue, Ql, Ql, Uue
Xue, Uue, Uue^Esd, Uue, Uue, Uue, Qxua, Qxua, Qxua, Qxua, Qxua, Uue, Uue, Ur, Uue, Uue, Uue, Uue, Ur, Ur, Uu^Uf, Uu^Uf, Uu^Uf, Uu^Uf, Uue, Urb, Uue, Uue, Xoc, Xoc, Uue, Uue, Uue, Uue^Br\, Uue^Br\, Xoc, Uue, Uue, Ql, Ql, Ql, Uue
Xue, Uue, Uue, Uue, Uue, Qxua, Qxua, Qxua, Qxua, Uu^Vu, Qxua, Qxua, Qxu^Bcx/, Ur, Uu^Vu, Uue, Uue, Uue, Ur, Uue, Uu^Edb, Uu^Uf, Uu^Uf, Uu^Uf, Xu, Uue, Uue, Uue, Uue, Uue, Ql, Ql, Uue, Uue, Uue, Uue^Br\, Uue^Br|, Uue, Uue, Uue, Uue, Uue
Xue, Uue, Uue, Qxua, Qxua, Qxua, Qxua, Qxua, Qxua, Qxua, Uue, Uue, Qxua, Ur, Ur, Uue, Uue, Uue, Ur, Uue, Uue, Xu, Xu, Xu, Urb, Uue, Uue, Uue, Uue, Uue, Uue, Ql, Uue, Uue, Uue, Uue, Uue^Br|, Uue, Uue, Uue, Ql, Xoc
Xue, Uue, Uue, Qxua, Qxua, Urb, Urb, Qxua, Qxua, Qxua, Uue, Qxua, Qxua, Qxua, Qxua, Ur, Xu, Uue, Ur, Uue, Uue, Uue, Uue, Uue, Uue, Uue, Uue, Uue, Uue, Uue, Uue, Uue, Uue, Uue, Uue, Uue, Uue^Br|, Uue, Uue, Uue, Xoc, Xoc
Xue, Uue, Uue, Uue, Qxua, Qxua, Qxua, Qxua, Qxua, Qxua, Uue, Uue, Qxua, Ql, Qxua, Xu, Xu, Xu, Ur, Uu^Vu, Ur, Ur, Ur, Uue, Uue, Uue, Uue^Edt, Uue, Uue, Uue, Uue, Uue, Uue, Uue, Uue, Uue, Uue^Br|, Uue^Br\, Uue^Br\, Uue, Uue, Uue
Xu, Xu, Uue, Uue, Qxua, Qxua, Qxua, Qxua, Qxua, Uue, Uue, Uue, Qxua, Ql, Ql, Qxua, Qxua, Xu, Uue, Ur, Uue, Uue, Uue, Ur, Ur, Uue, Uue, Uue, Uue, Uue, Uue, Uue, Uue, Uue, Uue, Uue, Uue^Br|, Uue, Uue, Uue^Br\, Uue^Br\, Uue
Xu, Xu, Uue, Uue, Uue, Uue, Qxua, Uu^Vu, Qxua, Uue, Uue, Uue, Uue, Qxua, Ql, Qxua, Qxua, Ur, Uue, Uue, Uue, Xu, Uue, Uue, Uue, Ur, Ur, Uu^Vu, Ur, Uue, Ur, Ur, Ur, Uue, Uue, Uue, Uue^Br|, Uue, Uue, Uue, Uue, Uue^Br\
Xu, Uue, Xu, Xu, Uue, Uue, Uue, Qxua, Qxua, Uue, Uue, Uue, Uu^Vu, Uue, Urb, Qxua, Ur, Ur, Uue, Uue, Xu, Xu, Uue, Uue, Uue, Uue, Uue, Ur, Uue, Ur, Uue, Uu^Vu, Uue, Ur, Uue, Uue, Cud, Uue, Uue, Uue, Xoc, Xoc
Xu, Xu, Xu, Uue, Uu^Vu, Uue, Urb, Uue, Qxua, Uue, Ur^Br/, Ur^Br\, Ur^Br\, Ur, Ur, Qxu^Bs/, Uue^Br\, Uue^Br/, Xu, Xu, Xu, Uue, Uue, Uue, Uue, Uue, Uue, Uue, Uue, Uue, Uue, Uue, Uue, Ur, Cud, Cud, Cud, Cud, Cud, Uue, Xoc, Xoc
Xu, Xu, Xu, Ur, Ur, Ur, Urb, Uue, Ur^Br/, Ur^Br/, Urb, Xu, Uue, Uue^Br\, Uue^Br\, Uue^Br/, Uue, Uue^Br\, Uue^Br\, Xu, Xu, Uue, Uue, Uue, Uue, Uue, Uue, Uue^Edt, Uue, Uue, Uue, Uue, Uue, Ur, Cud, Cud, Cud, Cud, Cud, Uue, Uue, Uue
Xu, Xu, Xu, Uue, Urb, Uue^Edb, Ur^Br|, Ur^Br/, Uue, Xu, Xu, Xu, Xu, Uue, Uue, Uue, Uue, Uue, Uue, Uue^Br\, Xu, Xu, Uue, Uue, Uue, Uue, Uu^Vu, Uue, Uue, Uue, Xu, Qxu, Uue, Uue, Cud, Cud, Uu^Vud, Cud, Cud, Uue, Uue, Uue
Xu, Uue, Uue, Qxu, Uue, Uue, Ur^Br|, Ur, Xu, Uue, Xu, Xu, Xu, Uue, Uue, Uue, Uue, Uue, Uue, Uue^Br|, Uue^Br\, Uue, Uue, Uue, Uue, Uue, Uue, Xu, Uue, Xu, Xu, Xu, Uue, Uue, Cud, Cud, Cud, Cud, Cud, Qxua, Qxua, Uue
Uue, Uue, Xu, Xu, Ur, Ur, Ur^Br|, Uue, Uu^Vu, Xu, Uue, Xu, Xu, Uue, Uue, Uue, Uue, Uue, Uue, Xu, Xu, Uue^Br\, Uue^Br\, Uue, Uue, Uue, Qxu, Xu, Xu, Xu, Xu, Uue, Uue, Uue, Uue, Cud, Cud, Cud, Qxua, Uu^Vu, Qxua, Qxua
Uue, Xu, Xu, Urb, Xu, Ur, Ur^Br|, Xu, Xu, Xu, Xu, Uue, Uue, Xu, Xu, Xu, Xu, Xu, Xu, Xu, Uue, Uue, Uue, Uue^Br\, Uue^Br\, Xue, Uue, Xu, Uue, Xu, Uue, Uue, Uu^Vu, Uue, Uue^Br/, Uue^Br/, Uue, Uue, Uue, Qxua, Qxua, Qxua
Uue, Xu, Uu^Vu, Xu, Uue^Br/, Uue^Br/, Uue, Uue, Xu, Xu, Qxua, Uue, Uue, Uue^Edb, Xu, Uue, Xu, Xu, Xu, Xu, Xu, Uue, Xoc, Xoc, Uue, Uue^Br\, Uue^Br\, Uue, Uue, Uue, Uue^Br/, Uue, Uue^Br/, Uue^Br/, Uue, Uue^Edt, Uue, Uue, Uue, Qxua, Qxua, Qxua
Xu, Xu, Xu, Uue^Br/, Uue, Uue, Qxu, Uue, Uue, Xu, Qxua, Uue, Uue, Uue, Xu, Xu, Xu, Xu, Uue, Xu, Xu, Uue, Uue, Uue, Uue, Uue, Uu^Vu, Uue^Br\, Uue^Br\, Uue^Br/, Uue, Uue^Br\, Uue, Qxu, Uue, Uue, Xu, Uue, Uue, Qxua, Qxua, Qxua
Xu, Uue, Uue, Uue, Uue, Qxu, Uue, Uue, Xu, Xu, Xu, Qxua, Xu, Xu, Xu, Xu, Xu, Xu, Xu, Xu, Uue, Uue, Uue, Uue, Uue, Uue, Uue, Uue, Uue, Xu, Uue, Uue, Uue, Uue, Uue, Xu, Xu, Xu, Uue, Qxua^Edt, Qxua, Qxua
Xu, Uue, Uue, Xu, Uue, Qxu, Uue, Uue, Xu, Xu, Xu, Xu, Xu, Xu, Xu, Xu, Xu, Xu, Xu, Uue, Uue, Uue, Uue, Uue, Ql, Ql, Ql, Uue, Uue, Xu, Xu, Xu, Xu, Xu, Xu, Xu, Xu, Xu, Uue, Uue, Urb, Urb
