Aa^Fpa, Ai, Ai, Ai, Aa^Fpa, Aa^Fpa, Aa^Fpa, Aa^Fpa, Aa^Fpa, Aa^Fpa, Aa^Fpa, Aa^Fpa, Aa^Fpa, Aa^Fpa, Aa^Fpa, Aa^Fpa, Aa^Fpa, Aa^Fpa, Aa^Fpa, Aa^Fpa, Aa^Fpa, Aa^Fpa, Aa^Fpa, Aa^Fpa, Aa^Fpa, Aa^Fpa, Aa^Fpa, Aa^Fpa, Aa^Fpa, Aa^Fpa, Aa^Fpa, Aa^Fpa, Aa^Fpa, Aa^Fpa, Aa^Fpa, Mm, Aa^Fpa, Ms, Ms, Ms^Xm, Ms^Xm, Ms^Xm, Ms^Xm, Ms^Xm, Ms^Xm, Ms, Ms, Aa, Ha, Aa, Ha, Aa, Ha, Aa, Ha, Ha, Ha, Ha, Ha, Ha, Ha, Ha, Ha, Ha, Ha, Ha, Ha, Ha, Ha, Dd, Ha, Dd
Aa^Fpa, Aa^Fpa, Aa^Fpa, Ai, Aa^Fpa, Aa^Fpa, Aa^Fda, Aa^Vca, Aa, Aa, Aa, Aa^Fpa, Aa^Fpa, Aa^Fda, Aa^Fda, Aa^Fpa, Aa^Fpa, Aa^Fda, Aa^Fpa, Aa^Fpa, Aa, Aa^Fpa, Aa^Fpa, Aa^Fda, Aa^Fda, Aa^Fpa, Aa, Aa^Fpa, Aa^Fpa, Aa^Fpa, Aa, Aa^Fpa, Aa, Aa^Fpa, Aa^Fpa, Aa^Fpa, Aa^Fpa, Aa^Fpa, Ms, Ms, Ms, Ms^Xm, Ms^Xm, Ms^Xm, Ms, Ms, Ha, Ha, Ha, Ha, Ha, Ha, Ha, Ha, Ha, Ha, Ha, Ha, Ha, Ha, Ha, Ha, Ha, Ha, Ha, Aa^Vaa, Ha, Ha, Koa, Koa, Koa, Ha
Aa^Fpa, Aa^Fpa, Aa^Fpa, Ai, Sm^Bw/, Aa, Aa^Fda, Aa^Fda, Aa^Fpa, Aa^Fpa, Aa^Fpa, Aa, Aa, Aa^Fda, Aa, Aa^Fpa, Aa, Aa^Fpa, Aa, Aa, Aa^Fpa, Aa, Aa, Aa^Fpa, Aa, Aa, Aa^Fpa, Aa, Aa, Aa^Fda, Aa^Fda, Aa, Aa^Fda, Aa, Gll, Aa^Fpa, Aa^Fpa, Ha, Ha, Ms, Ms, Ms^Xm, Ms, Ms, Ha, Ha, Ha, Ha, Aa, Ha, Ai, Ai, Ai, Ha, Ha, Ha, Ha, Ha, Aa, Ha, Aa, Aa, Aa, Ha, Ha, Ha, Ha, Ha, Aa, Koa, Ha, Ha
Aa^Fpa, Aa^Fpa, Aa^Vaa, Aa, Aa^Fpa, Ai, Aa^Fda, Aa^Fda, Aa^Fda, Aa^Fpa, Aa^Fpa, Aa, Aa^Fda, Aa, Aa, Aa^Fda, Aa, Aa^Vca, Aa, Aa^Fpa, Aa, Aa, Aa^Fpa, Aa, Aa^Fda, Aa^Fpa, Aa^Fpa, Aa^Fda, Aa, Aa^Fda, Aa, Aa^Fda, Aa, Aa, Aa^Fpa, Gll, Gll, Ha, Ha, Ha, Ha, Ms, Ms, Ms, Ha, Ha, Aa, Aa, Ha, Aa, Aa, Ai, Ai, Ai, Ai, Ha, Ha, Aa, Aa, Aa, Ms, Aa, Aa, Aa, Aa, Aa, Aa, Aa, Ha, Ha, Ha, Ha
Aa^Fpa, Aa^Fpa, Aa, Aa^Fpa, Gg^Em, Ai, Gg, Aa^Fda, Aa^Fda, Aa^Fpa, Aa^Fpa, Aa^Fpa, Aa^Fpa, Aa^Fda, Aa^Fpa, Aa, Aa^Fda, Aa, Aa^Fda, Aa^Fda, Aa^Fda, Aa^Fda, Aa^Fpa, Aa^Fda, Aa^Fda, Aa^Fpa, Aa^Fda, Aa^Fda, Aa, Aa, Aa^Fpa, Aa, Aa^Fda, Aa^Fma, Aa^Fma, Aa^Fpa, Aa^Fpa, Gll, Gll, Ha, Ha, Ha, Hhd, Hhd, Re, Aa, Ha, Ha, Ha, Ha, Ha, Aa, Aa, Ai, Aa, Ai, Aa, Aa, Ms, Ms, Aa^Fma, Aa^Fda, Aa^Fda, Aa, Aa, Aa, Aa, Ha, Ha, Aa, Aa, Ha
Aa^Fpa, Aa, Aa, Aa^Fpa, Aa^Fpa, Ai, Ai, Aa^Fda, Gg^Em, Aa^Fda, Gg, Aa^Fda, Aa^Fpa, Aa^Fpa, Aa^Fpa, Aa, Aa^Fda, Aa^Fda, Aa^Fda, Aa^Fpa, Aa^Fpa, Aa^Fda, Aa^Fda, Aa^Fda, Aa^Fpa, Aa^Fpa, Aa^Fpa, Aa^Fpa, Aa, Aa^Fpa, Aa^Fpa, Aa^Fpa, Aa^Fpa, Aa^Fda, Aa^Fma, Aa^Fma, Aa^Fpa, Aa^Fpa, Aa^Fpa, Gll, Gll, Ha, Gll, Re, Hhd, Ha, Ms, Ms, Ms, Ha, Ha, Ha, Ha, Aa, Aa, Aa, Ha, Ms^Xm, Ms, Aa^Fpa, Ms^Xm, Aa^Fda, Aa^Fda, Aa^Fda, Aa^Fda, Aa, Ha, Aa, Aa, Aa, Ha, Ha
Aa^Fpa, Aa, Aa^Fpa, Aa^Fpa, Gg^Em, Gg^Em, Gg^Em, Ai, Kvr, Gg, Gg, Aa^Fda, Aa^Fda, Aa^Fpa, Aa^Fda, Aa, Aa^Fpa, Aa^Fda, Aa^Fda, Aa^Fda, Aa^Fpa, Aa^Fpa, Aa^Fpa, Aa^Fda, Aa^Fpa, Aa^Fpa, Aa^Fda, Aa^Fda, Aa, Aa^Fda, Aa^Fda, Aa^Fpa, Aa^Fpa, Aa^Fpa, Aa^Fpa, Aa^Fpa, Aa^Fpa, Aa^Fpa, Aa^Fpa, Aa^Fpa, Hh, Gll, Hh, Hhd, Hhd, Hhd, Ms, Ms, Ms, Ha, Ha, Ha, Ha, Ha, Aa, Ms, Ha, Aa^Fpa, Aa^Fma, Ms^Xm, Ms^Xm, Ms^Xm, Ms, Ms^Xm, Ha, Ha, Ha, Ha, Aa, Ha, Ha, Ha
Aa^Fpa, Aa, Aa, Aa^Fpa, Aa^Fpa, Gg^Em, Gg, Wwr, Wwt, Cvr, Gg, Gg^Efm, Gg, Gg, Aa^Fda, Aa^Fpa, Aa^Fpa, Aa^Fpa, Aa^Fda, Aa^Fda, Aa^Fda, Aa^Fpa, Aa^Vca, Aa^Fda, Aa^Fda, Aa^Fda, Aa^Fpa, Aa^Fda, Aa, Aa, Aa, Aa^Fda, Gs, Aa^Fpa, Mm, Aa^Fpa, Aa^Fpa, Aa^Fpa, Gs^Efm, Aa^Fpa, Hh, Gll, Hh, Hhd, Hhd, Hhd, Md, Ms^Xm, Ms, Ms, Ms, Ha, Ha, Ha, Aa, Ha, Ha, Ha, Aa^Fma, Ms, Ms^Xm, Aa^Fda, Aa^Fda, Aa^Fma, Ms, Ha, Ha, Aa, Aa, Ha, Ha, Ha
Aa^Fpa, Aa^Fpa, Aa, Aa^Fpa, Gg, Gg, Gg, Wwt, Wwt, Wwt, Wwt, Gg, Gg, Gg, Gg, Gll, Gg, Gg, Gg, Aa^Fda, Aa^Fma, Aa^Fpa, Aa^Fpa, Aa^Fda, Aa^Fpa, Aa^Fpa, Aa^Fda, Aa^Fda, Gll, Gll^Fdw, Gg^Efm, Gs, Gs, Gs, Gs, Gs^Vh, Gll, Gs, Hh, Hh, Hh, Gll, Hh, Hhd, Hhd, Md, Md, Ms^Xm, Ms^Xm, Ms, Ms, Ha, Ha, Ha, Aa, Ha, Ha, Ha, Aa^Fda, Aa^Fda, Aa^Fda, Aa^Fma, Aa^Fma, Ms, Ha, Ha, Aa, Ha, Aa, Ha, Aa^Fma, Aa^Fda
Aa^Fpa, Aa^Fpa, Aa, Aa^Fpa, Gg, Gg^Efm, Gg, Gg^Em, Wwt, Wot^Ewf, Wot, Wwt, Gg, Gg, Gg, Gll, Gg, Gg, Gg^Efm, Gg, Aa^Fpa, Aa^Fma, Aa^Fpa, Aa^Fda, Aa^Fpa, Aa, Aa^Fpa, Aa^Fda, Gll, Gll^Fdw, Gg, Gs, Gll^Fdf, Gs^Efm, Gs, Gs, Gll, Gs, Hh, Hh, Hh, Gll, Hhd, Hhd, Md, Md, Ms^Xm, Ms^Xm, Ms^Xm, Ms^Xm, Ms^Xm, Ms, Ms, Ha, Aa, Ha, Ms, Ha, Ms, Aa^Fpa, Ms^Xm, Ms^Xm, Ha, Ha, Ha, Ha, Aa, Aa, Aa^Fda, Aa^Fda, Aa^Fma, Aa^Fda
Aa^Fpa, Aa^Fpa, Gll, Gg, Gg, Gg, Gg, Wwt, Wot, Wot, Wwt, Wwt, Gg^Efm, Gg, Gll, Gll, Gll, Gg, Gg, Gg, Aa^Fpa, Aa^Fma, Aa^Fpa, Aa^Fda, Aa^Fpa, Aa^Fda, Aa^Fpa, Aa^Fpa, Gll, Gg, Gll^Fdf, Gll^Fdf, Gll^Fdf, Gs, Gll^Fdf, Gs, Gll, Hh, Hh, Hh, Gll, Gll, Gll, Hhd, Md, Md, Md^Xm, Ms^Xm, Ms^Xm, Ms^Xm, Ms^Xm, Ms^Xm, Ms, Ms, Aa, Ms, Gll^Fdf, Gll^Fdf, Gll^Fdf, Ms, Hhd, Hhd, Rd, Ha, Rd, Aa, Aa^Fda, Aa^Fma, Aa^Fma, Aa^Fma, Ai, Wwt
Gg, Gg, Gll, Gg, Gg^Efm, Gg, Gg^Em, Wwt, Wot, Wot^Ewf, Wwt, Gg^Em, Gg, Gg, Gll, Gg, Gll^Fmf, Gll, Gll, Aa^Fda, Aa^Fpa, Aa^Fpa, Aa^Fda, Aa^Fda, Aa^Fda, Aa^Fda, Aa^Fda, Gg, Gll, Gll^Fdf, Gll^Fdf, Gll^Fdw, Gll^Fdw, Gll^Fdf, Gll^Fdf, Gll^Fdf, Gll, Hh, Gll, Gll, Mm, Mm, Gll, Md, Md, Md, Md, Md, Md, Ms, Ms, Ms, Ms, Ms, Gll, Gll^Fdf, Hhd, Hhd, Hhd, Hhd, Rd, Rd, Hhd, Hhd, Rd, Gd^Edpp, Gd, Aa^Fma, Ai, Ai, Ai, Wwt
Gg, Gg, Gll, Gg, Gg, Gg, Wwt, Wwt, Wot^Ewf, Wot, Wwt, Wwt, Gg, Gg, Gll, Gll^Fmf, Gll^Fmf, Gll^Fmf, Gll^Fmf, Gll, Gll, Aa^Fpa, Aa^Fda, Aa^Fda, Aa^Fpa, Aa^Fpa, Aa^Fda, Gg, Gll, Gll^Fdf, Gll^Fdf, Gll^Fdw, Gll^Fdw, Gll^Fdf, Hh, Hh, Gll, Gll, Mm, Mm, Mm, Mm, Mm^Xm, Gll, Gll, Md, Md, Md, Hhd, Hhd, Hhd, Ms, Gll^Fdf, Gll^Fdf, Gll, Gll, Gll, Gs^Vl, Hhd, Rd^Fts, Gll, Hhd, Gd, Hhd, Rd, Hhd, Wwrt, Ai, Ai, Ai, Wot, Wot
Gg, Gg, Gll, Gg, Gg^Efm, Gg, Wwt, Wot, Wwt, Wwt, Gg, Gg, Gll^Fmf, Gll^Fmf, Gll, Gll^Fmf, Gll^Fdf, Gll^Fdf, Gll^Fdf, Gll^Fmf, Gll^Fmf, Gll, Gll, Aa^Fpa, Aa^Fpa, Aa^Fpa, Gll, Gll, Gg, Gll, Gll, Gll^Fdf, Gll^Fdf, Gll^Fdf, Gll, Gll, Hhd, Hhd, Mm, Mm, Mm, Mm, Mm, Mm^Xm, Mm^Xm, Gll, Gll, Hhd, Hhd, Hhd, Hhd, Gll^Fdf, Gll^Fdf, Gll^Fdf, Gll, Gll, Gll, Gll, Gll, Gll, Gd, Gd, Ds, Ds, Wwf, Wwrt, Wwt, Wwt, Wot, Wot, Wwt, Wwt
Hh^Efm, Gg, Gll, Gg, Gg, Gg, Wwt, Wwt, Wwr, Gg, Gg^Efm, Gg, Gll, Gll, Gg^Ve, Gll^Fdf, Gll^Fdf, Gll^Fdf, Mm, Gll^Fmf, Gll^Fmf, Gll^Fmf, Gll^Fmf, Gll, Gll, Gll, Hhd, Gll^Fdf, Gll^Fdf, Gll^Fmw, Gll^Fmw, Gll, Gll, Gll, Gs^Fms, Hhd, Hhd, Hhd, Mm, Mm, Mm, Mm^Xm, Mm, Mm, Mm, Mm, Hhd, Gll, Gll, Hhd, Hhd, Gll^Fdf, Gll, Gll, Gd^Edp, Gll, Gll, Gll, Gd^Fts, Gd^Edp, Ds, Ds, Wwt, Wwf, Wwf, Wwrt, Wwt, Wot, Wwt, Wwt, Wwt, Wwt
Hh, Gg, Gll, Gg, Hh^Efm, Hh, Gg, Wwf, Gg^Em, Hh, Hh, Gll, Gg, Gg, Gll^Fmf, Mm, Mm, Mm, Mm, Mm, Mm, Mm, Gll^Fdf, Hhd, Re, Hhd, Hhd, Gll^Fdf, Gll^Fdf, Gll^Fdf, Gll^Fmw, Gll^Fmw, Gll, Gs^Fms, Gs^Fms, Hhd, Hhd, Hhd, Hhd, Mm, Mm, Mm, Mm, Mm, Mm, Mm, Hhd, Hhd, Hhd, Gll, Gll, Gll, Gd^Edp, Gd^Edp, Gd^Fts, Gd^Edp, Gd^Fts, Gd^Fts, Gd^Edp, Ds, Wwt, Wwt^Bw\, Wwt^Bw\, Wwt^Ewf, Wwf, Wwt^Ewf, Wwrt, Wwt, Wwt, Wwt, Rd, Rd
Hh, Gg, Gll, Gg, Hh, Hh, Gg^Efm, Wwf, Wwf, Hh, Hh, Gll, Hh, Gg^Efm, Mm^Xm, Mm^Xm, Mm^Xm, Mm^Xm, Mm^Xm, Mm, Mm, Mm, Gll^Fdf, Hhd, Re, Hhd, Hhd, Gll^Fdf, Gll^Fdf, Gll^Fdf, Gll^Fdf, Gll^Fmw, Gg, Gll, Gll, Gs^Fms, Hhd, Hhd, Hhd, Hhd, Hhd, Mm, Mm, Mm, Hhd, Hhd, Hhd, Hhd, Hhd, Hhd, Gll, Gd^Fts, Gd^Fts, Gd^Fts, Gd^Fts, Gd^Edp, Gd^Fts, Gd^Fts, Gd^Fts, Ds, Wwt, Wwt, Wwt, Wwt^Bw\, Wwf^Bw\, Wwf, Wwf, Wwrt, Gd, Rd, Dd, Dd
Mm, Hh, Gll, Hh, Mm, Mm, Mm^Xm, Mm^Xm, Wwg, Mm^Xm, Mm^Xm, Gll, Mm^Xm, Mm^Xm, Xu, Xu, Xu, Xu, Xu, Mm^Xm, Mm^Xm, Mm, Mm, Rd, Hh^Esd, Re, Re, Hhd, Mm, Mm^Xm, Mm, Rr^Vo, Gg^Efm, Gs^Fms, Gs^Fms, Gll, Gs^Fms, Hhd, Hhd, Hhd, Hhd, Hhd, Hhd, Hhd, Hhd, Hhd, Hhd, Hhd, Gs, Gs^Edp, Gll, Gd^Edp, Gd^Edp, Gd^Edp, Gd^Edp, Gd^Fts, Gd^Fts, Gd^Fts, Wwrt, Wwt, Wwt, Wot, Wwt, Wwt^Ewf, Wwf, Sm^Bw\, Gd, Gd, Rd, Dd, Dd, Ds
Mm^Xm, Hh, Gll, Hh, Mm^Xm, Mm^Xm, Xu, Xu, Wog, Xu, Ur, Re, Uh, Xu, Uh^Fdw, Xu, Xu, Xu, Xu, Xu, Xu, Mm^Xm, Mm^Xm, Rd, Hh, Hh, Hh^Fms, Re, Re, Mm, Mm, Gs^Fms, Gs^Fms, Gs^Fms, Gs^Fms, Gll, Gs^Fms, Gs^Fms, Gs^Fms, Hhd, Hhd, Hhd, Hhd, Hhd, Hhd, Hhd, Gs, Gs, Gs, Gs, Gll, Gd^Edp, Ds, Ds, Ds, Gd^Fts, Wwrt, Wwrt, Wwt, Wwt, Wot, Wot, Wwt, Wwt, Gd, Re, Gd, Gd, Rd, Dd, Dd^Esd, Hd^Esd
Xu, Mm^Xm, Md^Xm, Mm^Xm, Xu, Xu, Xu, Xu, Wog, Uh^Fdw, Qxu, Ur, Ur, Uu^Fdw, Uu, Uu^Fdw, Cte, Ko, Uu^Fdw, Uh^Fdw, Xu, Xu, Rd, Rd, Mm, Mm, Mm^Xm, Mm, Re, Mm, Mm^Xm, Mm, Hh, Gs^Fms, Gs^Fms, Gll, Gll, Gs^Fms, Gs^Fms, Hhd, Gll, Hhd, Gll, Hhd, Ke, Ce, Gs, Gs, Gll, Gll, Gs, Ds, Wwt, Wwt, Wwt, Wwt, Wwt, Wwt, Wot, Wot, Wwt, Wwt, Wwf, Wwf, Gd, Re, Gd, Rd, Dd, Dd^Dc, Hd, Hd
Xu, Xu, Xu, Xu, Xu, Xu, Xu, Wog, Qxu, Uu^Fdw, Qxu, Uu, Ur, Uh, Qxu, Uu^Fdw, Uu^Fdw, Uu^Fdw, Uu^Fdw, Uu^Fdw, Xu, Xu, Rd, Mm, Mm, Mm^Xm, Mm, Re, Mm, Mm, Mm, Mm, Hh^Fms, Gs^Fms, Gs^Fms, Gs^Fms, Gs^Fms, Gll, Gll, Gll, Hh, Gll, Hh, Gll, Gs, Re, Re, Gll, Gs, Gs, Ds, Ds, Wwt, Wwt, Wot, Wwt, Wot, Wot, Wwt, Wwt, Wwf, Wwf, Gs, Gs, Re, Re, Rd, Dd, Dd, Dd, Hd, Hd
Xu, Xu, Xu, Xu, Xu, Xu, Xu, Xu, Xu, Qxu, Qxu, Qxu, Ur, Xu, Uu^Fdw, Xu, Ur^Edb, Uu^Fdw, Uh^Fdw, Uh^Fdw, Ur^Edb, Ur, Mm^Xm, Rd, Rd, Mm, Re, Re, Hh, Hh^Esd, Hh, Hh^Fms, Hh, Gs^Fms, Gs^Fms, Gs^Fms, Gll, Gll, Gs, Gs, Gs, Hh, Gs, Gs, Ww, Ww, Wwf, Gs, Ds, Ds, Wwt, Wwt, Wwt, Wwt, Wot, Wot, Wwt, Wwt, Wwt, Wwt, Gs^Fts, Gs^Fts, Gd, Gd, Re, Dd, Dd, Rd, Rd, Dd, Rd, Hd
Xu, Xu, Xu, Xu, Xu, Xu, Xu, Uh^Fdw, Uu^Fdw, Xu, Uu^Eff, Qxu, Ur, Uh, Ur, Xu, Ur, Ur, Ur, Ur^Edb, Ur, Xu, Xu, Mm^Xm, Mm^Xm, Re, Re, Hh, Hh^Edp, Hh, Hh, Hh, Mm, Gs^Fms, Hh, Gll, Wot, Wot, Wot, Gs, Ww, Gs, Ww, Ww, Ww, Wot, Ww^Bh|, Ds, Wwt, Wwt^Bw\, Wwt^Bw\, Wwt, Wot, Wot, Wwt, Wwt, Wwt, Wwrt, Hh^Fts, Hh^Fts, Gd, Gd, Re, Re, Dd, Dd^Esd, Ds, Dd, Mdd, Rd, Mdd, Hd
Xu, Xu, Xu, Xu, Xu, Xu, Xu, Uh^Fdw, Uu^Fdw, Uu^Vu, Uu^Eff, Uu^Eff, Ur^Edt, Ur^Edt, Xu, Ur, Xu, Uh^Fdw, Uh^Fdw, Uu, Uh^Fdw, Xu, Xu, Xu, Mm^Xm, Mm, Re, Hh^Edp, Gs^Edp, Hh^Edp, Hh, Mm, Mm^Xm, Mm, Wot, Wot^Bsb|, Wot, Wot, Wot, Wot, Ww, Ww, Ww, Wot, Wot, Wot, Ww^Bh|, Wwt, Wwt, Wwt, Wot, Wot^Bw\, Wwt^Bw\, Wwt, Wwt, Wwt, Hh^Fts, Hh^Fts, Hh^Fts, Gs^Fts, Re, Re, Rd, Dd, Dd, Dd, Rd, Ds, Mdd, Rd, Dd, Mdd
Xu, Xu, Xu, Xu, Uu^Emf, Uh, Qxu, Uu^Fdw, Uu, Ur, Ur^Edt, Ur^Edt, Uh^Edb, Uu^Edb, Xu, Xu, Mm^Xm, Xu, Xu, Ur^Fdw, Xu, Xu, Xu, Xu, Mm^Xm, Mm, Re, Gs, Gs^Edp, Hh^Edp, Mm, Mm, Ww, Mm, Wot, Wot^Bsb|, Wot, Wot, Wot, Wot, Wot, Wot, Wot, Ww, Ww, Ww, Re, Wwrt, Wwrt, Wwt, Wwt, Wwt, Wwt, Wwt^Bw\, Ds, Ds, Hh, Hh^Fts, Gs^Fts, Gs^Fts, Re, Rd, Dd^Ftd, Ds^Edp, Dd, Dd, Ds^Edpp, Dd^Edp, Dd^Vdt, Rd, Mdd, Mdd
Xu, Xu, Xu, Xu, Uh, Uh, Uu, Uu, Uu^Edt, Ur^Edt, Uu^Edb, Ur, Ur, Xu, Xu, Mm^Xm, Md, Mm^Xm, Mm^Xm, Xu, Xu, Xu, Xu, Mm^Xm, Mm, Mm, Re, Gs, Hh, Hh, Wot, Ww, Wot, Wot, Wot, Wot^Bsb|, Wot, Wot, Wot, Wot, Wot, Wot, Wot, Wot, Hh, Gg^Ve, Re, Hh, Hh, Wwrt, Wwt, Wwt, Ds, Ds, Ds, Ds, Ds, Hh, Gs, Gd, Re, Gd, Dd, Ds, Dd^Esd, Dd, Dd, Mdd, Dd, Rd, Rd, Mdd
Xu, Xu, Xu, Xu, Xu, Uh, Uh, Xu, Ur, Ur, Uu^Fdw, Xu, Ur, Xu, Mm^Xm, Mm^Xm, Hh^Fdw, Md, Md, Mm^Xm, Mm^Xm, Xu, Mm^Xm, Mm^Xm, Gs, Gs, Rr, Gs, Wot, Wot, Wot, Wot, Wot, Wot, Wot, Wot^Bsb|, Wot, Wot, Wot, Wot, Wot, Wot, Wot, Wot, Re, Re, Gs^Fms, Gll, Gll, Wwrt, Wwrt, Wwrt, Gg, Gs^Ftd, Gs, Gg, Gg, Hh, Gg^Gvs, Gd^Gvs, Re, Gd, Rd, Dd, Dd, Dd, Dd^Ftd, Dd^Do, Ds, Dd, Rd, Mdd
Xu, Xu, Xu, Xu, Ur, Uh, Qxu, Qxu, Ur, Uu^Edt, Xu, Xu, Mm^Xm, Re, Gll, Hh, Gll, Md, Md, Md, Ch^Edt, Mm^Xm, Mm, Mm, Rr, Rr, Mm, Wot^Bsb\, Wot^Bsb\, Wot, Wot, Wot, Wot, Wot, Wot, Wot^Bsb|, Wot, Wot, Wot, Wot, Wot, Wot, Wot^Bsb/, Wot^Bsb/, Wot, Gs^Fms, Wot, Gs^Fms, Ww, Wwf, Wwf, Wwrt, Gg, Gg, Gg^Efm, Gg, Gg, Gg^Gvs, Gll, Gll, Cte, Re, Re, Rd, Rd, Dd, Ds, Dd, Dd, Dd^Ftd, Rd, Mdd
Xu, Xu, Xu, Xu, Qxu^Bp|, Qxu, Qxu, Qxu, Qxu^Bs/, Ur, Xu, Xu, Mm^Xm, Md, Hh^Fdw, Gll, Hh^Fdw, Gll, Ce, Ch^Edt, Ch^Vd, Ch^Edt, Ce, Rr, Gs, Mm, Wwr, Wot, Wot, Wot^Bsb\, Wot^Bsb\, Wot, Wot, Wot, Ch, Ch, Ch, Wot, Wot, Wot, Wot^Bsb/, Wot^Bsb/, Wot, Wot, Wot, Wot, Wot, Wot, Wot, Ww, Ww, Wwf, Gll, Gg, Gg, Gg, Gll, Gll, Gg, Gs, Wwf, Kte, Gs, Re, Re, Dd, Dd, Dd^Esd, Rd, Dd^Ftd, Rd, Mdd
Xu, Xu, Xu, Xu, Xu, Qxu^Bp\, Ur^Edb, Qxu^Bs/, Qxu, Xu, Xu, Xu, Mm^Xm, Md, Md, Gll, Md, Md, Ch^Edt, Ce, Ce, Ce, Cv^Fds, Ch, Ch^Edt, Mm, Wot, Wot, Wot, Wot, Wot, Wot^Bsb\, Ch, Ch, Kh, Kh, Kh, Ch, Ch, Wot^Bsb/, Wot, Wot, Wot, Wot, Wot, Wot, Wot, Wot, Wot, Ww, Gg^Ft, Gg, Gg, Gll, Gll, Gll, Gg, Gg, Wwf, Wwf, Wwf^Ewf, Wwf, Wwf, Gd, Re, Rd, Rd, Dd, Re, Re, Dd, Mdd
Xu, Xu, Xu, Xu, Xu, Qxu, Ur^Edb, Qxu, Uu^Edb, Qxu, Qxu, Xu, Xu, Mm^Xm, Mm, Wwf, Wwg, Wwg, Ww, Chw^Ewl, Chw^Bsb|, Cv^Fds, Ch, Ch, Chw, Wwr, Wot, Wot, Wot, Wot, Wot, Wot, Ch, Kh, Kh, Kh, Kh, Kh, Ch, Wot, Wot, Wot, Wot, Wot, Wot, Wot, Wot, Wot, Wot, Ww, Gg^Ft, Gg, Gg, Gg, Gll, Gg^Ft, Gg^Ft, Gg^Ft, Ss^Ft, Wwf^Ewf, Ss, Wwf^Ewf, Wwf^Ewf, Gs, Gd, Re, Re, Re, Gd^Gvs, Gd^Gvs, Gd, Dd
Xu, Xu, Xu, Xu, Xu, Uu, Uh, Ur^Edt, Ur^Edt, Uu^Edb, Uu^Emf, Xu, Mm^Xm, Mm^Xm, Hh, Wwf, Ww, Ww, Ww, Ww, Ww, Chw, Chw, Chw^Ewl, Chw^Ewf, Wwr, Wot, Wot, Wot, Wot, Wot, Wot, Ch, Kh, Kh, Kh, Kh, Kh, Ch, Wot, Wot, Wot, Wot, Wot, Wot, Wot, Wot, Wot, Mm, Gg^Ft, Gg^Ft, Gg^Ft, Gg^Ft, Gg^Ft, Gll, Gg^Ft, Ss^Ft, Ss^Ft, Ss^Ft, Ss^Ft, Ss^Ewf, Ss, Wwf^Ewf, Wwf, Gs, Gd, Gll, Gd^Gvs, Gs, Gd, Gd, Gd
Xu, Xu, Xu, Xu, Xu, Xu, Uh, Ur^Edt, Qxu, Ur^Edt, Xu, Xu, Mm^Xm, Mm, Hh, Wwf, Wwg, Ww, Ww, Ch, Kh, Ww, Chw^Ewl, Chw^Ewf, Chw^Ewl, Wot, Wot, Wot, Wot, Wot, Wot, Wot, Ch, Kh, Kh, Kh, Kh, Kh, Ch, Wot, Wot, Wot, Wot, Wot, Wot, Wot, Mm, Mm, Mm^Xm, Mm, Gg^Ft, Gg^Ft, Gg^Ft, Gg^Ft, Gll, Gg^Ft, Ss^Ft, Ss^Ft, Ss^Ft, Ss^Ft, Ss^Ft, Ss, Wwf^Ewf, Wwf, Gs, Gs, Gll, Gs, Gs, Gs, Gs, Gd
Xu, Xu, Xu, Xu, Xu, Xu, Xu, Uh, Xu, Ur^Edt, Ur^Edt, Xu, Xu, Mm^Xm, Mm^Xm, Wwf, Md, Chw, Chw, Ww, Ww, Ww, Chw^Ewl, Chw^Ewf, Chw, Wwr, Wot, Wot, Wot, Wot, Wot^Bsb/, Wot^Bsb/, Wot, Ch, Ch, Kh, Ch, Ch, Wot, Wot^Bsb\, Wot^Bsb\, Wot, Wot, Wot, Wot, Ww, Mm^Xm, Mm^Xm, Mm, Mm, Mm, Gg^Ft, Gg^Ft, Gg^Ft, Rp, Gg^Ft, Ss^Ft, Ss^Ft, Ss^Ft, Ss^Ft, Ss^Ft, Ss^Ft, Ss^Ft, Gg^Ft, Gg^Ft, Gll, Gg^Ft, Gs, Gg^Ft, Gs, Gs, Gs
Xu, Xu, Xu, Xu, Mm, Xu, Xu, Xu, Xu, Xu, Xu, Rb, Mm, Mm^Xm, Md, Gll, Md, Md, Ch^Edt, Chw, Chw^Bsb|, Chw, Cv^Fds, Cv^Fds, Cv^Fds, Chw^Ewl, Ch^Edt, Wot, Wot^Bsb/, Wot^Bsb/, Wot, Wot, Wot, Wot, Wot, Ch, Wot, Wot, Wot, Wot, Wot, Wot^Bsb\, Wot^Bsb\, Wot, Wot, Mm, Mm, Mm, Mm, Mm, Gg^Ft, Gg^Ft, Gll, Gll, Gg^Ft, Rp, Rp, Ss^Ft, Ss^Vhs, Ss^Ft, Ss^Ft, Gg^Ft, Gg^Ft, Gg^Ft, Gll, Gll, Gg^Ft, Gg^Ft, Gg^Ft, Gg^Ft, Gg^Ft, Gs
Mm^Xm, Xu, Mm^Xm, Md^Xm, Hh, Mm^Xm, Mm^Xm, Mm^Xm, Mm^Xm, Xu, Mm, Rb, Hh^Fds, Mm, Hh^Fds, Gll, Md, Md, Ch^Edt, Cv^Fds, Ce, Cv^Fds, Cv^Efm, Cv^Fds, Ce, Ce, Ce, Wot^Bsb/, Wot, Wot, Wot, Wot, Wot, Wot, Wot, Wot^Bsb|, Wot, Wot, Wot, Wot, Wot, Wot, Wot, Wot^Bsb\, Rp, Gg^Ft, Gg^Ft, Gg^Ft, Gg^Ft, Gg^Ft, Gll, Gll, Gg^Ft, Gg^Ft, Hh^Ft, Gg^Ft, Gg^Ft, Rp, Rp, Ss^Ft, Gg^Ft, Gg^Ft, Gg^Ft, Gg^Ft, Gll, Gg^Ft, Gg^Ft, Gg^Ft, Gg^Ft, Gg^Ft, Gg^Ft, Gg^Ft
Mm, Mm^Xm, Mm, Re, Hh, Mm, Mm, Mm, Mm, Mm^Xm, Hh^Fds, Re, Hh, Hh^Fds, Gs^Fds, Re, Gs^Gvs, Gs^Gvs, Gs^Gvs, Ch, Ce, Ce, Ce, Ch^Vhc, Ce, Cv^Fds, Ch, Ch, Ch^Edt, Wot, Wot, Wot, Wot, Wot, Wot, Wot^Bsb|, Wot, Wot, Wot, Wot, Wot, Wot, Wot, Wot, Rp, Rp, Gll^Efm, Gll, Gll, Gll, Gg^Ft, Gll, Gll, Mm, Mm, Hh^Ft, Hh^Ft, Gg^Ft, Mm, Rp, Rp, Gg^Ft, Gg^Efm, Gg^Ft, Gll, Gg, Gg^Ft, Gg^Ft, Gg^Ft, Gg^Ft, Gg^Ft, Gg^Ft
Mm, Mm, Hh, Re, Re, Mm, Hh, Mm, Hh, Hh, Re, Re, Re, Hh, Re, Re, Re, Re, Re, Gs^Gvs, Rp, Ch, Ch, Ce, Ch, Ch, Wwr, Wwr, Ww, Wot, Wot, Wot, Wot, Wot, Wot, Wot^Bsb|, Wot, Wot, Wot, Wot, Wot, Wot, Wot, Wot, Rp, Gs^Ft, Md, Gg^Ft, Gg^Ft, Gg^Ft, Hh^Ft, Gg^Ft, Hh, Gll, Md, Mm, Md, Mm, Mm, Gg^Ft, Gg^Ft, Gll, Gll, Gll, Gg, Gg^Efm, Gg^Ft, Gg^Ft, Gg^Ft, Gg^Ft, Gg^Ft, Gg^Ft
Mm, Mm, Hh, Hh, Gs^Gvs, Re, Re, Hh, Re, Re, Gs^Gvs, Gs^Gvs, Gs^Gvs, Re, Gs^Gvs, Gs^Gvs, Gs^Gvs, Gs^Gvs, Gs^Gvs, Re, Rp, Gs^Gvs, Gs^Gvs, Ch^Edt, Gs^Fds, Wwr, Ww, Ww, Ww, Wot, Wot, Wot, Wot, Wot, Wot, Wot^Bsb|, Wot, Wot, Ss, Wot, Rb, Wot, Ss, Ss^Ftr, Rd, Md^Ft, Md^Ft, Md, Md, Hh^Ft, Md, Md, Md, Gll, Gll, Md, Md, Md, Md, Hh^Ft, Gg^Ft, Gg^Efm, Gll, Gg, Gg^Ft, Gg^Ft, Hh^Ft, Gg^Ft, Gg^Ft, Gg^Ft, Gg^Ft, Gg^Ft
Mm, Hh, Gs^Gvs, Hh, Gs^Gvs, Gs^Gvs, Gs^Gvs, Re, Gs^Gvs, Gs^Gvs, Gs^Gvs, Gs^Gvs, Gs^Gvs, Gs^Gvs, Gs^Gvs, Gs^Gvs, Gs^Gvs, Gs^Gvs, Gs^Gvs, Gs^Gvs, Rp, Gs^Gvs, Gs^Gvs, Gs^Gvs, Gs^Fds, Ww, Ww, Ww, Ww, Wot, Wot, Wot, Ss, Ss, Ss, Wot^Bsb|, Ss, Ss, Rb, Ss, Rb, Rb^Es, Ss, Ss^Ftr, Rr, Md^Ftr, Md, Md^Ft, Md, Md, Md, Md, Md, Md, Md, Gll, Md, Md^Xm, Md, Hh^Ft, Hh^Ft, Gg, Gll, Gg^Ft, Hh^Ft, Hh^Ft, Hh^Ft, Mm^Ft, Mm^Ft, Gg^Ft, Gg^Ft, Gg^Ft
Hh, Gs^Gvs, Gs^Gvs, Gs^Gvs, Gs^Gvs, Gg^Vwm, Gs, Re, Gs^Gvs, Gs^Gvs, Hh, Hh, Hh, Hh, Hh, Gs^Gvs, Gs^Gvs, Gs^Gvs, Rp, Rp, Gs^Gvs, Gs^Gvs, Gs^Gvs, Gs^Gvs, Wwr, Ww, Wo, Wo, Ww, Ww, Ss, Ss, Ss, Ss, Rb, Re, Gll^Ft, Ss, Ss, Rb, Ss, Sm, Ss, Sm^Ftr, Rd, Md^Ftr, Md^Ft, Md, Md, Md, Hhd, Hhd, Hhd, Md, Md, Gll, Md, Md^Xm, Md^Xm, Md, Hh^Ft, Gg^Ft, Gll, Gg^Ft, Gg^Ft, Hh^Ft, Hh^Ft, Mm^Ft, Hh^Ft, Mm^Ft, Gg^Ft, Gg^Ft
Gs^Gvs, Gs^Gvs, Gs^Gvs, Gs^Gvs, Gs^Gvs, Gs, Gs^Gvs, Re, Gs^Gvs, Gs^Gvs, Hh, Mm, Wwr, Wwr, Ww, Gs^Fds, Gs^Edp, Gs, Rp, Gs^Gvs, Gs^Gvs, Gs^Gvs, Gs^Fds, Gs^Fds, Ww, Ww, Wo, Ww, Ww, Ss, Ss, Ss, Rb, Sm, Hhd, Re, Rb^Ft, Ss, Sm, Ss, Ss, Ss, Rb, Sm, Re, Md^Ftr, Md, Md^Ft, Hhd, Hhd^Vhh, Hhd, Hhd, Gll, Gll, Gll, Gll, Xoc, Mm^Xm, Mm^Xm, Md, Hh^Ft, Gg^Ft, Gg^Ft, Gll, Gll, Gg^Ft, Gg^Efm, Hh^Ft, Hh^Ft, Hh^Ft, Gg^Ft, Gg^Ft
Gs^Gvs, Gs^Gvs, Gs^Gvs, Gs^Gvs, Gs^Gvs, Gs^Gvs, Re, Re, Gs^Eff, Gs^Eff, Wwr, Wwr, Ww, Ww, Ww, Ww, Ww, Gs, Rp, Gs, Ww, Gs^Fds, Ww, Gs^Fds, Ww, Ww, Ww, Ww, Ss, Ss, Ss, Ss, Rb, Hhd, Re^Es, Re, Re, Rb^Ft, Ss, Ss, Sm, Wwf, Sm, Sm, Rd, Md^Ftr, Md^Ft, Md, Gll, Gll, Gll, Gll, Mm^Xm, Md, Xoc, Rb, Uue, Xoc, Xoc, Mm^Xm, Mm, Mm^Ft, Mm^Ft, Gg^Ft, Gg^Ft, Gll, Gg^Efm, Hh, Mm, Hh^Ft, Gll^Ft, Gg^Ft
Gs^Gvs, Gs^Gvs, Gs^Gvs, Gs^Gvs, Re, Re, Gs^Eff, Gs^Eff, Ww, Ww, Ww, Ww, Wo, Wo, Wo, Ww, Ww, Ww, Ww^Bsb|, Ww, Ww, Ww, Ww, Ww, Ww, Ww, Ww, Ww, Ss, Ss, Ss, Ss, Ss^Bw/r, Rb, Rb, Rb, Rb, Ss^Bw\r, Ss^Bw\r, Ss, Ss, Ss, Khs^Eff, Rd, Re, Gll^Ftr, Gll, Gll^Efm, Md, Hhd, Md, Md, Md^Xm, Xoc, Xoc, Re, Uue, Uue^Edp, Uue^Em, Xoc, Xoc, Mm, Mm, Hh^Ft, Gg^Efm, Gll, Gg^Efm, Hh, Mm, Hh^Ft, Gll^Ft, Gll^Ft
Gs^Gvs, Gs^Gvs, Re, Re, Gs^Eff, Gs^Eff, Ww, Ww, Ww, Ww, Wo, Wo, Ww, Ww, Ww, Wo, Ww, Ww, Ww^Bsb|, Wo, Wo, Wo, Wo, Wo, Ww, Ww, Ss, Ss, Hhd, Ss, Ss^Bw/r, Ss^Bw/r, Ss, Ss, Ss, Ss, Sm, Ss, Ss, Ss^Bw\r, Re, Re^Eff, Re, Chr, Re, Re, Gll^Ftr, Rb^Ft, Md, Md, Md^Xm, Md^Xm, Md^Xm, Xoc, Xoc, Re, Qxua, Uue^Edt, Xue, Re^Edt, Xoc, Xoc, Xoc, Mm, Gll, Gll, Hh, Hh, Mm, Hh^Ft, Gll^Ft, Mm^Xm
Ww, Wwr, Wwf, Gs^Edpp, Ww, Ww, Ww, Ww, Wo, Wo, Ww, Ww, Wwr, Ww, Ww, Ww, Ww, Ww, Ww^Bsb|, Ww, Ww, Wo, Ww, Ww, Ss, Ss, Hhd, Hhd, Re, Re, Rb^Es, Ss, Rb, Ss, Ss, Hhd, Hhd, Ss, Ss, Ss, Rb^Eff, Rb^Edb, Re^Edb, Re, Md, Re, Md, Md, Md, Md, Md^Xm, Md^Xm, Mm^Xm, Xoc, Re, Rb, Uue^Uf, Qxua, Uue, Xoc, Xoc, Xoc, Rb, Rb, Mm, Gg^Efm, Hh, Hh, Mm^Xm, Mm^Xm, Xu, Xue
Ww, Ww, Wwf, Ww, Ww, Ww, Wo, Wo, Ww, Ww, Wwr, Wwr, Mm, Mm, Hh, Wwr, Wwr, Ww, Rp, Ww, Wwr, Ww, Wwr, Ss, Ss, Sm, Sm, Re, Re^Es, Rb^Es, Ss, Ss, Ss, Sm, Ww^Vm, Ss, Ss, Ss, Rb, Ss, Wwf, Rb^Eff, Md, Md, Md, Gll, Gll, Md, Md, Md^Xm, Mm^Xm, Mm^Xm, Xoc, Xoc, Re, Uue^Emf, Qxua, Qxua, Xoc, Uue^Edp, Rb, Rb, Uue^Edp, Xoc, Xoc, Mm^Xm, Mm^Xm, Hh, Mm^Xm, Xue, Xu, Xue
Wo, Ww, Wwf, Ww, Ww, Wo, Ww, Ww, Ww, Ww, Hh, Hh, Hh, Hh, Gs^Edp, Hh, Gs^Edp, Gs^Edp, Rp, Gs, Gs^Edp, Gg^Edp, Hh, Ss, Ss, Ss, Sm, Re, Re, Wog, Wog, Wog, Ss, Sm, Ss, Ss, Ss, Ss, Wog, Rb, Ss, Rb, Md, Md^Xm, Md^Xm, Md, Md, Gll, Gll, Mm^Xm, Xoc, Xoc, Re, Uue^Emf, Xue, Re, Re, Uue^Edt, Uh, Qxua, Re, Uue^Em, Uue^Fdw, Xoc, Rb^Fdw, Xoc, Xoc, Mm^Xm, Xoc, Xoc, Xu, Xue
Ww, Ww, Wwf, Ww, Ww, Ww, Ww, Ww, Gs^Edp, Hh, Gs^Edp, Hh, Gs, Gs, Gs, Gs, Gs, Gs, Re, Gs, Gs, Gg^Edp, Hh, Ss, Wwf, Sm, Sm, Rb^Es, Hhd, Rb, Ss, Sm, Rb, Rb, Rb, Sm^Es, Ss, Ss, Sm, Rb, Ss, Ss, Md, Md^Xm, Mm, Mm, Mm, Mm^Xm, Xoc, Re, Rb, Re, Uue^Emf, Rb, Re, Re, Xue, Re, Rb, Re, Xue, Re^Fdw, Uue^Uf, Uue^Uf, Uue^Uf, Uue^Uf, Uue^Fdw, Xoc, Xoc, Xoc, Xu, Xue
Gs^Edp, Ww^Ewl, Re, Ww^Ewl, Wwr, Ww, Gs^Edp, Gs^Edp, Re, Gs^Edp, Gs, Gs, Re, Re, Re, Re, Re, Re, Gs, Rp, Re, Gg, Gg, Gg, Wwf, Wwf, Ss, Ss, Ss, Ss, Rb, Sm, Ss, Ss, Sm, Ss, Sm, Ss, Sm, Rb, Ss, Ss, Mm, Mm, Mm, Mm, Mm, Mm^Xm, Xoc, Uue^Emf, Re, Rb^Uf, Qxua, Qxua, Uue^Uf, Re, Qxe, Xuc, Rb^Vud, Xuc, Uue^Uf, Uue^Uf, Uue^Uf, Re^Uf, Rb^Uf, Rb^Uf, Uue^Uf, Xoc, Xoc, Xoc, Xu, Xue
Gs^Fmw, Gs^Edp, Re, Gs^Edp, Gs^Edp, Gs^Edp, Re, Re, Gs, Re, Re, Re, Gs, Gs, Re, Gs, Gs, Gs, Gs, Gs^Edp, Gs^Edp, Gll, Gll, Gll, Gg^Edp, Ss, Ss, Ss, Rb, Ss, Gll, Hh, Sm, Ss, Ss, Rb, Rb, Sm, Rb, Rb, Rb, Rb, Mm, Mm^Xm, Mm, Mm, Mm, Mm^Xm, Re, Re, Xoc, Qxe^Bh\, Re, Qxua, Qxua, Re, Qxe^Bh/, Qxe^Bh/, Xoc, Rb, Xue, Xue, Qxua, Rb^Uf, Uh^Uf, Qxua, Xoc, Xoc, Uue^Em, Xuc, Xu, Xue
Gll^Fmw, Gll^Fmw, Re, Gs^Edp, Re, Re, Gs, Gs, Gs^Gvs, Gs, Gs^Gvs, Gs^Gvs, Gs^Gvs, Gs, Re, Gs, Gs^Gvs, Gs^Gvs, Gs^Gvs, Gs^Gvs, Gs^Gvs, Gs^Edp, Gll, Gg, Gg^Edp, Hh, Hh, Ss, Gg, Rb, Ss, Rb, Ss, Sm, Gll, Rb, Gll, Rb, Gll, Gll, Gll, Gll, Hh, Mm, Hh, Hh, Gll, Re, Mm^Xm, Xoc, Xoc, Qxua, Qxua, Qxe^Bh\, Re, Re, Re, Qxua, Uue, Uue, Uue^Em, Re, Uue^Emf, Re^Fdw, Xoc, Cer, Uue^Emf, Re^Em, Uue^Emf, Xuc, Xu, Xue
Gll^Fmw, Gll^Fmw, Gll^Edp, Re, Gs^Edp, Gs, Gs^Gvs, Gs^Gvs, Gs^Gvs, Gs^Gvs, Gs^Gvs, Gs^Gvs, Gs^Gvs, Gs^Gvs, Re, Gs, Gs^Gvs, Gs^Gvs, Gs^Gvs, Gs^Gvs, Gs^Gvs, Gs, Gll, Gg^Edp, Gg^Edp, Hh, Gg, Gg, Gll, Gll, Gg, Ss, Md, Md, Md, Md, Mm, Hh, Hh, Hh, Gll, Gs, Gs^Fmw, Mm, Gll, Gll, Mm, Mm, Md^Xm, Md^Xm, Mm^Xm, Xoc, Xoc, Qxua, Qxua, Xue, Uue^Emf, Rb, Uue, Xue, Uue, Hhd, Uue^Em, Uue^Emf, Xoc, Ket, Re^Uf, Uue^Uf, Xoc, Xuc, Xu, Xue
Hhd^Fmw, Gll^Fmw, Gll^Fmw, Gll^Fmw, Gs^Edp, Gs, Gs^Gvs, Gs^Gvs, Gs^Edp, Gs^Gvs, Gs^Edp, Gs^Edp, Gll^Fmw, Gll^Edp, Re, Gs^Edp, Gs^Edp, Gs^Gvs, Gs^Gvs, Gs^Gvs, Gs^Gvs, Gs^Gvs, Gs^Eff, Gll, Gll, Gg^Edp, Gg^Edp, Gll, Gg, Gg, Hh, Md, Mm^Xm, Mm^Xm, Mm^Xm, Mm, Mm, Hh, Gs^Fmw, Gs, Gll, Gs, Gll, Gll, Hh^Fmw, Mm, Mm, Mm, Mm, Md^Xm, Md^Xm, Mm^Xm, Xoc, Xoc, Qxua, Uue^Emf, Rb, Re, Re, Uue, Re, Uue, Qxua, Uue^Uf, Xoc, Xoc, Xoc, Xoc, Xoc, Xoc, Xoc, Xue
Hhd^Fmw, Hhd^Fmw, Hhd^Fmw, Gll^Fmw, Gs^Edp, Gs^Edp, Gs^Edp, Gs^Edp, Gll^Fmw, Gs^Edp, Gll, Gs^Vht, Gll, Gll^Efm, Gll^Fmw, Gll^Fmw, Gs, Gs^Gvs, Gs^Gvs, Gs^Gvs, Gs^Gvs, Gs^Gvs, Gs^Gvs, Gs^Eff, Gs^Eff, Gll, Gll, Gll, Gg, Hh, Hh, Mm, Mm, Mm^Xm, Mm^Xm, Mm^Xm, Mm, Hh^Fmw, Gs^Fmw, Gs, Gs, Gll, Gs, Gs^Fmw, Hh^Fmw, Mm^Fmw, Mm^Fmw, Mm, Mm, Md^Xm, Mm, Mm^Xm, Mm^Xm, Xoc, Xoc, Xoc, Xoc, Xoc, Rb, Xoc, Xoc, Uue, Uue, Uh, Xoc, Xoc, Mm^Xm, Xoc, Xoc, Xoc, Xoc, Xoc
Hhd^Fmw, Hhd^Fmw, Gll^Fmw, Gll^Fmw, Gll^Fmw, Gll^Fmw, Gll^Fmw, Gll^Fmw, Gll^Edp, Gll^Efm, Gll, Gll, Gll^Fmw, Gll^Edp, Gll^Fmw, Gll^Fmw, Gs^Edp, Gs, Gs^Gvs, Gs^Gvs, Gs^Gvs, Gs^Gvs, Gs^Gvs, Gs^Gvs, Gs^Gvs, Gs^Eff, Gs^Eff, Gll, Hh, Hh, Hh, Mm, Mm^Xm, Mm^Xm, Mm, Mm, Hh^Fmw, Hh^Fmw, Gs^Fmw, Gs, Gs, Gll, Gs^Fmw, Gs^Fmw, Gs^Fmw, Hh^Fmw, Hh^Fmw, Mm^Fmw, Hh^Fmw, Mm, Hh^Fmw, Mm, Mm, Mm^Xm, Xoc, Xoc, Mm^Xm, Mm, Gll, Mm, Mm^Xm, Xoc, Xoc, Xoc, Xoc, Mm^Xm, Hh^Fp, Mm^Xm, Mm^Xm, Xoc, Xoc, Xoc
Hhd^Fmw, Hhd^Fmw, Gll^Fmw, Gll^Fmw, Gll^Fmw, Gll^Fmw, Hhd^Fmw, Gll^Fmw, Gll^Fmw, Gll, Gll^Efm, Gll^Fmw, Gll^Fmw, Gll^Fmw, Gll^Fmw, Gll^Fmw, Gll^Fmw, Gs^Edp, Gs^Edp, Gs^Gvs, Gs, Gs, Gll^Fmw, Gs^Gvs, Gs^Gvs, Gs^Eff, Gs^Eff, Gll, Gll, Hh, Hh, Mm, Mm, Mm^Xm, Mm, Mm, Hh, Hh, Hh, Gs, Gs, Gll, Gs, Gs, Gs, Gs^Fmw, Hh, Hh^Fmw, Hh, Hh, Hh, Hh, Gs^Fmw, Mm^Xm, Mm^Xm, Mm^Xm, Gll, Gll, Gs, Hh, Mm, Mm^Xm, Xoc, Xoc, Mm^Xm, Mm^Xm, Hh, Hh, Mm, Xoc, Xoc, Xoc
Hhd^Fmw, Gll^Fmw, Gll^Fmw, Gll, Gll, Gll^Fmw, Ket, Gll^Fmw, Gll, Gll, Gll^Fmw, Gll, Gll, Gll^Fmw, Gll^Edp, Gll^Fmw, Hhd^Fmw, Gll^Fmw, Gll^Fmw, Gs^Edp, Gll^Fmw, Gll^Fmw, Hhd^Fmw, Gll^Fmw, Gll^Fmw, Gs^Gvs, Gs^Gvs, Gs^Eff, Gs^Eff, Gll, Gll, Gs, Hh, Mm, Gs^Edp, Hh, Gs, Hh, Hh, Gs, Gs, Gll, Gs, Re^Vct, Gs, Gs^Fmw, Gs^Fmw, Hh, Hh, Gs^Efm, Gll, Gs, Gs^Efm, Hh, Gs, Gll, Gs, Gs, Hh, Hh, Mm, Mm^Xm, Mm^Xm, Mm^Xm, Hh^Fp, Hh, Gg, Gs^Fp, Gs, Md^Xm, Xoc, Xoc
Hhd^Fmw, Gll^Fmw, Gll^Fmw, Gll^Fmw, Gll, Gll^Fmw, Gll^Fmw, Ce, Gll^Fmw, Gll^Fmw, Gll^Fmw, Gll^Fmw, Gll^Edp, Gll, Gll^Efm, Gll^Fmw, Gll^Fmw, Hhd^Fmw, Gll^Fmw, Gll^Fmw, Hhd^Fmw, Hhd^Fmw, Gll^Fmw, Gll^Fmw, Gll^Fmw, Gs^Gvs, Gs^Eff, Gs^Eff, Gll, Gll, Gs, Gll, Gll, Hh, Gll, Gll, Gll, Gs, Gs, Gs, Gll, Gll, Gll, Gs^Efm, Gs^Efm, Gs^Edp, Gll, Gll, Gll, Gll, Gs, Gll, Gll, Gs, Gll, Gll, Gs, Hh, Mm, Mm, Mm^Xm, Mm^Xm, Mm, Mm, Hh^Fp, Wwf, Gg, Gg, Hh, Mm, Xoc, Xoc
Hhd^Fmw, Hhd^Fmw, Gll^Fmw, Gll^Fmw, Gll^Fmw, Gll^Fmw, Gll^Fmw, Gll^Fmw, Gll^Fmw, Gll^Fmw, Gll^Fmw, Gll^Fmw, Gll^Fmw, Gll, Gll, Gll, Gll, Gll^Fmw, Gll, Gll^Fmw, Gll^Efm, Gll^Fmw, Gll, Gll, Gll^Efm, Gll^Fmw, Gll, Gll, Gs^Efm, Gs, Gs^Efm, Gs, Cer, Gll, Gs, Gs, Gs, Gll, Gll, Gll, Gs, Gs, Gs, Gll, Gll, Gll, Gs, Gs, Gs, Gs, Gs, Gs, Gs, Gll, Gs, Gs, Mm, Mm, Hh, Mm, Mm, Mm, Mm, Mm, Wwt, Wwf, Wwf, Wwf, Mm^Xm, Mm^Xm, Xoc, Xoc
Hhd^Fmw, Hhd^Fmw, Hhd^Fmw, Gll^Fmw, Gll^Fmw, Gll^Fmw, Gll^Fmw, Gll^Fmw, Hhd^Fmw, Hhd^Fmw, Hhd^Fmw, Gll^Fmw, Gll^Fmw, Gll^Fmw, Gll^Fmw, Gll^Fmw, Gll^Fmw, Gll, Gll^Fmw, Gll, Gll, Gll, Gll^Fmw, Gll^Fmw, Gll^Fmw, Gll, Gll^Fmw, Gll^Fmw, Gll^Fmw, Gs^Efm, Gs^Efm, Gs^Efm, Gs, Ker, Gs, Gs, Gs, Gs, Gs, Gs, Gs^Fmw, Gs^Efm, Gs^Edp, Gs, Gs, Gs, Gs, Gs, Hh, Hh, Hh, Hh, Hh, Gs, Hh, Gs^Efm, Hh, Hh, Hh, Hh, Hh, Hh, Hh^Fp, Wwrt, Wwt, Wot, Hh^Fp, Hh^Fp, Mm^Xm, Xoc, Xoc, Xoc
Hhd^Fmw, Hhd^Fmw, Hhd^Fmw, Hhd^Fmw, Hhd^Fmw, Hhd^Fmw, Hhd^Fmw, Hhd^Fmw, Hhd^Fmw, Hhd^Fmw, Hhd^Fmw, Hhd^Fmw, Hhd^Fmw, Hhd^Fmw, Hhd^Fmw, Hhd^Fmw, Gll^Fmw, Gll^Fmw, Gll^Fmw, Gll^Fmw, Gll^Fmw, Gll^Fmw, Gll^Fmw, Gll^Fmw, Gll^Fmw, Gll^Fmw, Gll^Fmw, Gll^Fmw, Gll^Fmw, Gs^Fmw, Gs, Gs^Edp, Gs, Gs, Gs, Gs, Gs, Gs, Gs^Fmw, Gs^Fmw, Gs^Fmw, Gs^Fmw, Gs^Fmw, Gs^Fmw, Gs^Fmw, Gs^Fmw, Gs^Fmw, Hh, Hh, Hh^Fmw, Hh, Hh^Fmw, Hh, Hh, Hh, Hh, Hh, Hh, Hh, Hh, Hh, Hh^Fp, Gs^Fp, Hh^Fp, Hh^Fp, Hh^Fp, Hh^Fp, Hh^Fp, Mm^Xm, Xoc, Xoc, Xoc
